Name,Pos,Team,Age,GP,G,A1,A2,P1,P,Sh
Kenny Agostino,LW,CHI,24.378,59,21,30,24,51,75,148
Daniel O'Regan,C,SJ,22.625,54,20,24,8,44,52,121
Taylor Beck,RW,BAK/HFD,25.342,48,16,27,16,43,59,148
Paul Carey,LW,HER,27.975,54,24,19,13,43,56,119
Corey Tropp,RW,SD,27.142,53,21,22,9,43,52,95
Wade Megan,C,CHI,26.151,62,27,15,12,42,54,159
Matt Lorito,C,GR,26.203,54,19,23,10,42,52,120
Ben Street,C,GR,29.586,57,23,19,9,42,51,181
Chris Terry,LW,STJ,27.441,47,24,17,14,41,55,151
Chris Bourque,LW,HER,30.627,65,17,24,14,41,55,197
Travis Morin,C,TEX,32.682,63,20,21,7,41,48,139
Cole Schneider,LW,RCH,26.055,58,19,21,9,40,49,142
Nicklas Jensen,LW,HFD,23.529,58,26,14,5,40,45,178
Cory Conacher,RW,SYR,26.753,48,14,25,13,39,52,133
Chris Conner,LW,LV,32.729,62,19,20,11,39,50,106
Tom Kostopoulos,RW,WBS,37.641,64,23,16,11,39,50,148
Jonny Brodzinski,RW,ONT,23.241,56,25,13,9,38,47,172
Greg Carey,LW,LV,26.447,64,26,12,8,38,46,196
Travis Boyd,C,HER,23.003,65,13,24,19,37,56,95
Chris Mueller,C,TUC,30.529,57,13,24,16,37,53,94
Christian Thomas,RW,HER,24.307,59,25,12,9,37,46,139
Mark Jankowski,C,STK,22.005,54,24,13,9,37,46,129
Anton Lander,C,BAK,25.395,31,22,15,9,37,46,83
Rocco Grimaldi,C,SA,23.6,63,26,11,9,37,46,191
Lucas Wallmark,C,CHA,21.027,62,23,14,6,37,43,134
T.J. Brennan,D,LV,27.452,64,20,16,16,36,52,190
Cal O'Reilly,C,RCH/TOR,29.959,52,9,27,12,36,48,83
Frederick Gaudreau,C,MIL,23.375,54,21,15,7,36,43,101
Pontus Aberg,RW,MIL,22.978,48,25,11,7,36,43,133
Phil Varone,C,BNG,25.781,53,13,23,7,36,43,97
Jake Guentzel,C,WBS,21.942,33,21,15,6,36,42,98
Matt Taormina,D,SYR,29.904,59,14,21,18,35,53,161
Christian Djoos,D,HER,22.11,56,12,23,15,35,50,72
T.J. Hensick,C,ONT,30.764,58,15,20,11,35,46,129
Andrew Poturalski,C,CHA,22.668,62,16,19,10,35,45,132
Byron Froese,C,TOR/SYR,25.512,50,25,10,7,35,42,141
Andreas Johnsson,LW,TOR,21.816,65,19,15,8,34,42,126
Linden Vey,C,STK,25.164,51,14,20,8,34,42,96
Andrew Agozzino,LW,CHI,25.699,60,15,19,7,34,41,109
Kerby Rychel,LW,TOR,21.94,62,17,16,14,33,47,163
Jordan Szwarz,RW,PRO,25.34,57,17,16,14,33,47,93
Martin Frk,RW,GR,22.945,55,23,10,13,33,46,207
Yanni Gourde,LW,SYR,24.751,55,22,11,13,33,46,135
Christian Fischer,RW,TUC,19.419,51,18,15,9,33,42,121
Darren Archibald,LW,UTI,26.597,64,20,13,8,33,41,151
Vladislav Kamenev,C,MIL,20.093,58,15,17,9,32,41,114
Stanislav Galiev,RW,HER,24.66,45,21,11,7,32,39,98
Ivan Barbashev,C,CHI,20.753,46,19,13,5,32,37,75
Teemu Pulkkinen,RW,IA,24.701,47,18,14,4,32,36,152
Tim Heed,D,SJ,25.633,45,12,19,16,31,47,107
Bracken Kearns,LW,BRI,35.345,62,20,11,12,31,43,125
Wayne Simpson,RW,PRO,26.822,64,15,16,11,31,42,107
Trevor Smith,C,MIL,31.6,63,12,19,10,31,41,125
Jason Akeson,RW,BNG,26.285,46,16,15,10,31,41,123
Colin McDonald,RW,LV,31.959,63,22,9,9,31,40,143
Dominik Simon,C,WBS,22.104,61,12,19,9,31,40,121
Brandon DeFazio,LW,TEX,28.005,63,19,12,9,31,40,180
Tanner Fritz,C,BRI,25.071,58,19,12,8,31,39,119
Matej Stransky,RW,TEX,23.181,63,20,11,7,31,38,158
Matt White,LW,MIL,27.063,59,13,18,7,31,38,152
Danick Martel,LW,LV,21.759,56,19,12,6,31,37,131
A.J. Greer,LW,SA,19.753,60,15,16,6,31,37,127
Samuel Blais,LW,CHI,20.247,64,21,10,5,31,36,102
Curtis Valk,C,UTI,23.6,63,16,14,12,30,42,135
Charles Hudon,C,STJ,22.23,45,23,7,9,30,39,130
Eric Tangradi,LW,GR,27.595,49,14,16,8,30,38,123
Kyle Connor,LW,MB,19.767,44,21,9,8,30,38,120
Matt Frattin,RW,STK,28.699,54,18,12,6,30,36,153
Barclay Goodrow,RW,SJ,23.551,52,21,9,6,30,36,134
Peter Cehlarik,LW,PRO,21.121,43,18,12,4,30,34,102
Alexandre Grenier,RW,UTI,25.027,57,17,12,13,29,42,132
Oskar Sundqvist,C,WBS,22.482,55,17,12,11,29,40,130
Evgeny Svechnikov,RW,GR,19.874,62,17,12,11,29,40,147
John Quenneville,C,ALB,20.416,53,12,17,11,29,40,138
Erik Condra,RW,SYR,30.11,44,10,19,9,29,38,89
Marcus Sorensen,LW,SJ,24.441,43,17,12,5,29,34,108
Jordan Weal,C,LV,24.419,43,15,13,17,28,45,97
David Warsofsky,D,WBS,26.296,49,15,13,16,28,44,185
Kevin Porter,C,WBS,30.512,60,10,18,12,28,40,106
Tomas Nosek,C,GR,24.038,49,15,13,12,28,40,89
Alex Grant,D,PRO,27.652,59,14,14,11,28,39,155
Chase Balisy,RW,SPR,24.616,64,13,15,10,28,38,75
Sonny Milano,LW,CLE,20.345,52,15,13,8,28,36,112
Kyle Criscuolo,C,GR,24.364,63,16,12,7,28,35,118
Andrew Mangiapane,LW,STK,20.449,55,14,14,6,28,34,106
Antoine Laganiere,LW,SD,26.197,54,20,8,5,28,33,135
Michael Dal Colle,LW,BRI,20.238,63,14,14,5,28,33,121
Adam Payerl,RW,MIL,25.534,64,15,13,4,28,32,121
Kasperi Kapanen,RW,TOR,20.148,41,17,10,13,27,40,118
Nikolay Goldobin,LW,SJ,20.94,46,15,12,13,27,40,91
Spencer Abbott,RW,RFD/SD,28.378,61,16,11,13,27,40,130
Kyle Wood,D,TUC,20.367,57,13,14,12,27,39,122
Mitch Callahan,RW,GR,25.079,53,14,13,9,27,36,120
Josh Ho-Sang,RW,BRI,20.647,48,10,17,9,27,36,61
Ryan Hamilton,LW,BAK,31.419,46,17,10,8,27,35,104
Blake Coleman,C,ALB,24.797,49,18,9,7,27,34,117
Nick Baptiste,RW,RCH,21.115,50,20,7,4,27,31,149
Brett Sutter,C,ONT,29.288,57,15,12,4,27,31,98
Paul Thompson,RW,SPR,27.792,39,16,11,4,27,31,121
Andy Miele,C,LV,28.419,53,8,18,20,26,46,98
Kalle Kossila,LW,SD,23.422,55,11,15,16,26,42,132
Brendan Leipsic,LW,TOR,22.326,38,12,14,12,26,38,110
Jack Roslovic,C,MB,19.627,56,12,14,12,26,38,119
Nikita Scherbak,RW,STJ,20.71,56,13,13,9,26,35,101
Ryan Pulock,D,BRI,21.942,43,12,14,9,26,35,106
Brandon Montour,D,SD,22.43,36,13,13,7,26,33,148
Colin Smith,C,TOR/SA,23.238,61,9,17,7,26,33,127
Jordan Subban,D,UTI,21.537,53,14,12,6,26,32,124
Sean Backman,RW,ONT,30.381,58,12,14,6,26,32,144
Joey LaLeggia,D,BAK,24.227,56,16,10,5,26,31,134
Jake DeBrusk,LW,PRO,19.912,62,13,12,13,25,38,169
Andrew Nielsen,D,TOR,19.838,63,12,13,11,25,36,120
Justin Fontaine,RW,HFD/BAK,28.858,56,11,14,11,25,36,92
Morgan Klimchuk,LW,STK,21.54,55,14,11,9,25,34,130
Mat Bodie,D,HFD/RCH,26.526,53,10,15,7,25,32,94
Marek Hrivik,C,HFD,25.049,44,14,11,7,25,32,86
Rourke Chartier,C,SJ,20.452,56,15,10,6,25,31,132
Justin Bailey,RW,RCH,21.208,40,19,6,4,25,29,106
Kevin Roy,LW,SD,23.323,56,13,11,16,24,40,139
Vince Dunn,D,CHI,19.879,61,12,12,13,24,37,140
Seth Griffith,RW,TOR,23.696,27,7,17,11,24,35,56
Cody Kunyk,C,UTI,26.323,52,13,11,10,24,34,91
Scott Laughton,C,LV,22.296,48,15,9,9,24,33,105
Mark Zengerle,RW,LV,27.345,59,12,12,8,24,32,78
Casey Bailey,RW,BNG,24.885,54,19,5,7,24,31,156
Jean-Sebastien Dea,C,WBS,22.6,62,16,8,6,24,30,105
Valentin Zykov,RW,CHA,21.337,55,15,9,6,24,30,101
Mike Sislo,RW,SA/TOR,28.652,62,12,12,5,24,29,146
Josh Archibald,RW,WBS,23.942,60,16,8,5,24,29,119
Garrett Wilson,LW,WBS,25.501,51,11,13,5,24,29,110
Liam O'Brien,LW,HER,22.132,55,9,15,3,24,27,79
Josh Currie,C,BAK,23.879,56,15,9,3,24,27,125
Kyle Flanagan,C,BNG,27.71,57,9,15,2,24,26,72
Danton Heinen,C,PRO,21.197,52,12,11,13,23,36,111
Mike Amadio,C,ONT,20.342,58,12,11,12,23,35,79
Sam Carrick,C,RFD/SD,24.611,65,14,9,11,23,34,172
Joe Whitney,LW,SA/TUC,28.605,63,12,11,10,23,33,146
Dan DeSalvo,C,MB,24.529,55,15,8,9,23,32,102
Ryan Carpenter,RW,SJ,25.658,43,9,14,8,23,31,105
Adam Tambellini,C,HFD,21.871,59,12,11,8,23,31,113
Pat Cannone,C,IA,30.101,60,8,15,8,23,31,91
J.T. Compher,C,SA,21.438,41,13,10,7,23,30,77
Trevor Moore,LW,TOR,21.488,46,12,11,6,23,29,62
Blake Pietila,LW,ALB,23.567,42,15,8,5,23,28,93
Oliver Bjorkstrand,RW,CLE,21.433,37,14,9,3,23,26,105
Matt Carey,RW,HFD,24.545,61,18,5,2,23,25,77
Steve Bernier,RW,BRI,31.46,33,17,6,2,23,25,64
Tommy Cross,D,PRO,27.008,63,12,10,12,22,34,109
Corban Knight,C,LV,26.014,60,8,14,11,22,33,95
Mark McNeill,C,RFD/TEX,23.562,68,8,14,11,22,33,162
Tyler Bertuzzi,LW,GR,21.556,42,11,11,11,22,33,99
Matthew Peca,C,SYR,23.386,56,10,12,11,22,33,107
Jamie McBain,D,TUC,28.553,53,6,16,10,22,32,98
Robbie Russo,D,GR,23.581,56,7,15,10,22,32,115
Will O'Neill,D,LV,28.384,57,3,19,9,22,31,95
Travis Sanheim,D,LV,20.466,64,10,12,9,22,31,138
Vincent LoVerde,D,ONT,27.422,53,7,15,9,22,31,91
Colby Cave,C,PRO,21.721,64,12,10,9,22,31,121
Ben Sexton,C,ALB,25.277,53,19,3,9,22,31,102
Chase De Leo,C,MB,20.89,58,13,9,8,22,30,132
Alex Tuch,RW,IA,20.351,44,15,7,8,22,30,99
Max McCormick,LW,BNG,24.375,55,18,4,8,22,30,144
Jason Dickinson,C,TEX,21.2,53,8,14,6,22,28,95
Mike Halmo,LW,SYR,25.337,59,16,6,6,22,28,118
Markus Hannikainen,LW,CLE,23.474,44,14,8,2,22,24,136
Joakim Ryan,D,SJ,23.247,54,8,13,15,21,36,149
Nick Paul,LW,BNG,21.49,60,11,10,11,21,32,114
Brian Gibbons,LW,ALB,28.551,61,13,8,9,21,30,107
Andrew Rowe,LW,BRI,28.647,54,10,11,9,21,30,98
Joel Vermin,RW,SYR,24.608,43,12,9,7,21,28,91
Kyle Baun,RW,RFD,24.367,63,13,8,7,21,28,104
Max Friberg,RW,STJ,23.819,60,10,11,6,21,27,83
John McCarthy,LW,SJ,30.101,56,16,5,5,21,26,121
Gabriel Bourque,LW,SA,25.978,49,9,12,5,21,26,85
Buddy Robinson,RW,BNG/SJ,24.959,55,13,8,4,21,25,117
Jeremy Morin,RW,SYR/TUC,25.416,52,11,10,3,21,24,90
Troy Bourke,LW,SA,22.463,64,9,12,2,21,23,82
Trevor Murphy,D,MIL,21.164,63,11,9,11,20,31,139
Teddy Purcell,RW,ONT,31.019,30,9,11,10,20,30,60
Mackenzie Weegar,D,SPR,22.688,51,12,8,10,20,30,157
Brett Sterling,LW,CHI,32.395,55,10,10,8,20,28,91
Michael Mersch,LW,ONT,23.953,39,13,7,8,20,28,114
Erik Gustafsson,D,RFD,24.534,57,6,14,8,20,28,153
Joshua Winquist,LW,BRI,23.025,43,12,8,8,20,28,70
Justin Dowling,C,TEX,25.956,45,8,12,7,20,27,84
Adam Erne,LW,SYR,21.405,39,14,6,7,20,27,81
Tanner Richard,C,SYR,23.444,39,12,8,7,20,27,68
Jakub Vrana,LW,HER,20.545,38,14,6,6,20,26,77
Grayson Downing,C,IA/TUC,24.411,55,9,11,5,20,25,89
Hunter Shinkaruk,LW,STK,21.923,41,8,12,5,20,25,99
Remi Elie,LW,TEX,21.416,50,8,12,4,20,24,79
Sean Kuraly,C,PRO,23.652,50,13,7,4,20,24,115
Mike Blunden,RW,BNG,29.751,55,13,7,4,20,24,128
Devon Toews,D,BRI,22.564,64,4,15,21,19,40,142
T.J. Tynan,C,CLE,24.553,59,8,11,14,19,33,95
Brad Hunt,D,CHI,28.06,23,9,10,10,19,29,57
Matthew Ford,RW,GR,31.934,39,9,10,9,19,28,80
Kevin Czuczman,D,MB,25.682,65,7,12,9,19,28,169
Matt Grzelcyk,D,PRO,22.693,58,5,14,8,19,27,99
Daniel Zaar,RW,CLE,22.395,49,8,11,7,19,26,136
Bobby Farnham,LW,STJ,27.649,60,9,10,5,19,24,76
Quinton Howden,LW,MB,24.649,58,13,6,5,19,24,97
Anthony Greco,RW,SPR,22.959,62,13,6,5,19,24,159
Daniel Audette,C,STJ,20.362,64,7,12,4,19,23,85
Brandon Mashinter,LW,RFD,27.986,50,11,8,4,19,23,81
Patrice Cormier,C,MB,26.255,58,11,8,1,19,20,90
Chandler Stephenson,C,HER,22.4,62,8,10,15,18,33,55
Julius Honka,D,TEX,20.784,46,6,12,12,18,30,114
Evan Rodrigues,LW,RCH,23.134,45,9,9,9,18,27,112
Gemel Smith,C,TEX,22.416,46,11,7,9,18,27,73
Pascal Pelletier,C,UTI,33.249,44,9,9,8,18,26,67
Ville Pokka,D,RFD,22.529,65,5,13,8,18,26,156
Jack Rodewald,RW,BNG,22.584,55,17,1,8,18,26,84
Justin Florek,LW,MIL,26.329,64,9,9,7,18,25,128
JC Lipon,RW,MB,23.184,65,9,9,7,18,25,148
Dryden Hunt,LW,SPR,20.808,58,10,8,7,18,25,115
Sam Anas,F,IA,23.29,54,11,7,6,18,24,91
Felix Girard,C,MIL/SA,22.353,61,7,11,6,18,24,99
Jesse Puljujarvi,RW,BAK,18.359,28,9,9,5,18,23,82
Laurent Dauphin,C,TUC,21.474,32,14,4,4,18,22,87
Timo Meier,C,SJ,19.937,32,12,6,3,18,21,93
Jordan Maletta,C,CLE,21.378,63,11,7,3,18,21,108
Kyle Rau,LW,SPR,23.893,36,8,10,3,18,21,80
Nick Lappin,RW,ALB,23.871,24,9,9,2,18,20,61
Kevin Rooney,C,ALB,23.321,60,10,8,0,18,18,94
Taylor Leier,LW,LV,22.581,36,9,8,12,17,29,88
Ryan Graves,D,HFD,21.321,64,7,10,12,17,29,168
Andrew Miller,RW,CHA,27.992,41,7,10,11,17,28,55
Jordan Schmaltz,D,CHI,22.937,42,3,14,8,17,25,52
Cole Bardreau,RW,LV,23.151,60,9,8,6,17,23,73
Alex Broadhurst,C,CLE,23.526,44,9,8,6,17,23,64
Joe Blandisi,C,ALB,22.162,28,7,10,6,17,23,55
Chris Brown,RW,HFD,25.614,52,12,5,6,17,23,100
Mario Lucia,F,IA,23.058,44,9,8,5,17,22,60
Stefan Matteau,LW,STJ,22.559,56,11,6,4,17,21,101
Carter Bancks,LW,UTI,27.101,60,8,9,4,17,21,63
Scott Glennie,C,MB,25.562,45,7,10,3,17,20,61
Nick Sorensen,RW,SD,21.896,46,9,8,3,17,20,81
Jayce Hawryluk,RW,SPR,20.704,35,7,10,3,17,20,58
Brendan Perlini,LW,TUC,20.386,17,14,3,2,17,19,49
Cole Ully,LW,TEX,21.567,48,11,6,2,17,19,94
Brendan Lemieux,LW,MB,20.504,61,12,5,2,17,19,120
Jordan Oesterle,D,BAK,24.225,37,7,9,11,16,27,75
Julius Bergman,D,SJ,20.868,54,3,13,10,16,26,118
Alexander Nylander,RW,RCH,18.54,57,9,7,9,16,25,96
Carter Camper,C,ALB,28.195,35,5,11,9,16,25,62
Teddy Blueger,C,WBS,22.085,42,5,11,8,16,24,66
Dmytro Timashov,LW,TOR,19.956,54,11,5,7,16,23,94
Sven Andrighetto,C,STJ,23.488,20,8,8,6,16,22,62
Nathan Walker,LW,HER,22.603,47,10,6,5,16,21,79
Evan McEneny,D,UTI,22.318,52,9,7,5,16,21,134
Borna Rendulic,RW,UTI,24.477,60,12,4,5,16,21,70
Adam Helewka,LW,SJ,21.153,47,12,4,5,16,21,86
Carter Verhaeghe,C,BRI,21.088,35,13,3,5,16,21,65
Colin Greening,C,TOR,30.521,61,8,8,4,16,20,95
Martin Lundberg,C,RFD,26.274,62,8,8,4,16,20,87
Patrick Brown,C,CHA,24.299,54,11,5,4,16,20,94
Michael McCarron,C,STJ,21.526,32,7,9,3,16,19,73
Adrian Kempe,LW,ONT,20.005,43,11,5,3,16,19,87
Jordan Samuels-Thomas,LW,SD,26.301,47,11,5,3,16,19,79
Phil Di Giuseppe,LW,CHA,22.934,33,11,5,3,16,19,119
Justin Scott,C,CLE,21.09,46,10,6,2,16,18,87
Joe Hicketts,D,GR,20.367,60,7,8,15,15,30,75
Alexandre Carrier,D,MIL,19.937,61,6,9,15,15,30,88
Brad Malone,C,HER/CHI,27.323,60,10,5,10,15,25,80
Chris Rumble,D,BNG,26.416,50,6,9,10,15,25,109
Mike Reilly,D,IA,23.175,44,5,10,9,15,24,104
Sena Acolatse,D,SPR,25.797,63,6,9,9,15,24,84
Francis Perron,LW,BNG,20.411,61,5,10,9,15,24,87
Jacob de la Rose,C,STJ,21.323,51,10,5,8,15,23,83
Jim O'Brien,C,SA,27.627,45,9,6,7,15,22,87
Sergey Tolchinsky,LW,CHA,21.614,51,7,8,7,15,22,97
Danny Kristo,RW,CHI/WBS/CHA,26.244,48,8,7,6,15,21,88
Michael Bunting,LW,TUC,20.995,56,11,4,5,15,20,112
Brett Findlay,C,TOR,23.756,26,9,6,4,15,19,34
Brandon Bollig,LW,STK,29.622,49,10,5,4,15,19,67
Tim Kennedy,C,RCH,30.378,34,4,11,4,15,19,40
Justin Auger,RW,ONT,22.34,56,11,4,4,15,19,117
Colton Hargrove,LW,PRO,24.225,55,7,8,4,15,19,103
Chris Wagner,C,SD,25.304,30,12,3,4,15,19,69
Chris Porter,LW,PRO,32.299,55,5,10,3,15,18,78
Peter Mueller,F,PRO,28.422,45,9,6,3,15,18,96
Peter Stoykewych,D,MB,24.173,62,5,10,3,15,18,112
Connor Brickley,LW,CHA,24.553,55,11,4,3,15,18,87
Emile Poirier,RW,STK,21.753,43,6,9,2,15,17,75
Jimmy Lodge,RW,MB,21.532,53,8,7,2,15,17,54
Kris Newbury,C,BAK/CHA,34.57,45,10,5,2,15,17,64
Patrick Dwyer,RW,CHA,33.233,44,6,9,2,15,17,57
Morgan Ellis,D,CHI,24.378,63,8,6,12,14,26,103
Scott Kosmachuk,RW,MB,22.641,49,9,5,10,14,24,111
Brendan Ranford,LW,TEX/TUC/SA,24.37,55,7,7,10,14,24,80
Jake Chelios,D,CHA,25.523,62,3,11,10,14,24,124
Gustav Olofsson,D,IA,21.789,48,5,9,8,14,22,77
Denis Gurianov,RW,TEX,19.274,46,8,6,7,14,21,76
Kyle Burroughs,D,BRI,21.178,59,3,11,7,14,21,104
Matt Mangene,D,TEX,27.512,55,6,8,6,14,20,93
Nick Ebert,D,TEX,22.348,55,7,7,6,14,20,104
Max Gortz,RW,MIL/SD,23.63,53,4,10,6,14,20,80
Garrett Mitchell,RW,HER,25.036,62,10,4,5,14,19,55
Ryan Lomberg,LW,STK,21.767,57,8,6,5,14,19,93
Derrick Pouliot,D,WBS,22.663,36,6,8,4,14,18,81
Magnus Paajarvi,LW,CHI,25.427,26,7,7,4,14,18,57
Colton Beck,LW,IA,26.266,62,3,11,4,14,18,90
Travis St. Denis,RW,BRI,23.995,47,10,4,4,14,18,89
Scott Allen,LW,BAK,26.195,49,8,6,4,14,18,70
Nicolas Aube-Kubel,RW,LV,20.351,60,9,5,3,14,17,65
Adam Comrie,D,SYR,26.126,45,8,6,3,14,17,72
Steven Fogarty,C,HFD,23.408,54,7,7,3,14,17,51
Bryce Gervais,C,CHI,24.551,52,11,3,2,14,16,75
Ryan Craig,LW,CLE,34.69,58,9,5,1,14,15,66
Tyler Motte,F,RFD,21.518,33,8,6,0,14,14,100
Ben Harpur,D,BNG,21.674,57,2,11,13,13,26,103
Jaycob Megna,D,SD,23.764,55,5,8,10,13,23,63
Andrew Welinski,D,SD,23.386,55,3,10,10,13,23,73
Jordan Caron,RW,CHI,25.868,46,3,10,9,13,22,83
Cameron Schilling,D,RFD/ONT,27.94,63,8,5,9,13,22,118
Carter Rowney,RW,WBS,26.351,26,10,3,8,13,21,50
Ethan Werek,C,TEX,25.274,42,8,5,7,13,20,99
Mark Olver,C,TUC/BAK,28.704,46,6,7,7,13,20,57
Kevin Labanc,RW,SJ,20.759,16,6,7,6,13,19,50
Kevin Fiala,LW,MIL,20.151,22,7,6,6,13,19,76
Christoph Bertschy,RW,IA,22.447,54,9,4,6,13,19,120
Nikita Jevpalovs,RW,SJ,22.016,55,12,1,5,13,18,73
Michael Latta,C,ONT/RFD,25.31,51,3,10,5,13,18,63
Riley Barber,RW,HER,22.603,28,9,4,4,13,17,70
Joe Pendenza,C,CLE,25.814,50,6,7,4,13,17,75
Griffin Reinhart,D,BAK,22.641,44,6,7,4,13,17,53
Zach Sanford,C,HER,21.849,25,11,2,3,13,16,63
Jake Virtanen,RW,UTI,20.079,53,6,7,3,13,16,121
Harry Zolnierczyk,LW,MIL,29.038,24,6,7,3,13,16,47
Jared McCann,C,SPR,20.293,31,6,7,3,13,16,64
Anton Blidh,LW,PRO,21.507,42,9,4,2,13,15,88
Scott Sabourin,RW,SD,24.129,44,6,7,0,13,13,75
Chris Butler,D,CHI,29.885,62,5,7,12,12,24,88
Andrew Campbell,D,TOR,28.611,64,5,7,8,12,20,85
Michael Kostka,D,BNG/STK,30.797,51,3,9,7,12,19,112
Zack Mitchell,RW,IA,23.688,49,10,2,6,12,18,60
Jujhar Khaira,C,BAK,22.09,24,8,4,6,12,18,60
Ryan Johnston,D,STJ,24.584,45,5,7,5,12,17,62
Sahir Gill,LW,WBS,24.403,40,5,7,5,12,17,29
Chad Billins,D,UTI,27.307,60,3,9,5,12,17,88
Paul LaDue,D,ONT,24.025,37,5,7,5,12,17,77
Jaime Sifers,D,CLE,33.658,61,6,6,5,12,17,94
Vojtech Mozik,D,ALB,23.721,54,8,4,5,12,17,119
Shane Harper,LW,SPR/ALB,27.619,46,7,5,5,12,17,63
Cristoval Nieves,C,HFD,22.644,40,6,6,5,12,17,55
Connor Jones,C,BRI,26.082,51,5,7,5,12,17,77
Tobias Lindberg,LW,TOR,21.151,39,6,6,4,12,16,62
Radel Fazleev,LW,LV,20.688,56,6,6,4,12,16,49
Tom Sestito,LW,WBS,28.964,33,6,6,4,12,16,34
Chad Ruhwedel,D,WBS,26.359,28,4,8,4,12,16,75
Ryan Haggerty,RW,WBS,23.534,46,10,2,4,12,16,76
Daniel Pribyl,C,STK,23.742,33,5,7,3,12,15,55
Landon Ferraro,C,CHI,25.104,22,7,5,3,12,15,57
Stefan Noesen,RW,SD,23.589,22,6,6,3,12,15,55
Garry Nunn,C,SA,26.847,44,8,4,3,12,15,75
Eric Cornel,RW,RCH,20.43,59,5,7,2,12,14,49
Tim Bozon,LW,SPR,22.479,36,7,5,2,12,14,45
Mark MacMillan,C,STJ,24.6,51,6,6,1,12,13,50
Anthony Richard,C,MIL,19.737,43,5,7,1,12,13,55
Colby Robak,D,STK/UTI,26.395,58,3,8,19,11,30,108
Andrew Bodnarchuk,D,TEX,28.181,60,5,6,14,11,25,86
Taylor Fedun,D,RCH,28.282,29,5,6,11,11,22,59
Reece Scarlett,D,ALB/SPR,23.46,51,5,6,11,11,22,88
Kurtis MacDermid,D,ONT,22.477,57,6,5,9,11,20,88
Steven Kampfer,D,HFD,27.975,43,4,7,8,11,19,99
Mark Barberio,D,STJ,26.482,20,3,8,7,11,18,45
Nathan Paetsch,D,GR,33.463,61,1,10,7,11,18,61
Jordan Schroeder,C,IA,25.962,25,6,5,7,11,18,65
Brett Lernout,D,STJ,20.975,65,3,8,6,11,17,74
Philip McRae,LW,HFD,26.504,64,8,3,6,11,17,114
Ryan Horvat,LW,SPR,23.597,47,5,6,6,11,17,70
Colby Williams,D,HER,21.636,55,4,7,5,11,16,33
Luke Johnson,C,RFD,21.989,62,7,4,5,11,16,106
Tyler Gaudet,C,TUC,23.449,51,3,8,4,11,15,101
Zach Sill,C,HER,28.312,57,7,4,4,11,15,62
Mike Angelidis,C,STK,31.219,39,5,6,4,11,15,58
Michael Carcone,LW,UTI,20.326,50,3,8,4,11,15,73
Chris Carlisle,D,BNG,21.748,62,3,8,4,11,15,60
Zbynek Michalek,D,TUC,33.729,43,6,5,3,11,14,90
Robert Hagg,D,LV,21.6,49,7,4,3,11,14,82
Andrew Crescenzi,C,ONT,24.132,51,6,5,3,11,14,52
Noel Acciari,C,PRO,24.789,30,6,5,3,11,14,65
Nick Moutrey,LW,CLE,21.227,48,5,6,2,11,13,72
Tyler Morley,C,SD,24.74,39,4,7,2,11,13,71
Jan Mandat,C,ALB,20.825,40,5,6,2,11,13,41
Levko Koper,LW,CHA,25.945,45,7,4,2,11,13,62
Rod Pelley,LW,ALB,32.038,62,6,5,1,11,12,69
Ryan Kujawinski,C,ALB,21.463,31,6,5,1,11,12,40
Ross Johnston,LW,BRI,22.573,51,7,4,1,11,12,38
Jeremy Gregoire,C,STJ,21.027,51,8,3,0,11,11,63
Travis Dermott,D,TOR,19.732,50,5,5,13,10,23,78
John Ramage,D,CLE,25.603,56,4,6,12,10,22,107
John Gilmour,D,HFD,23.332,64,4,6,12,10,22,92
Tanner Kero,C,RFD,24.145,28,7,3,10,10,20,59
Kane Lafranchise,D,BRI,28.304,56,4,6,9,10,19,75
Aaron Ness,D,HER,26.329,50,5,5,8,10,18,74
Dean Kukan,D,CLE,23.189,59,2,8,8,10,18,71
Haydn Fleury,D,CHA,20.189,55,3,7,8,10,18,114
Erik Burgdoerfer,D,RCH,27.762,50,1,9,7,10,17,60
Justin Holl,D,TOR,24.625,61,6,4,6,10,16,98
Wacey Hamilton,C,UTI,26.014,55,8,2,6,10,16,65
Chris Bigras,D,SA,21.562,39,4,6,6,10,16,62
Garnet Hathaway,RW,STK,24.811,20,6,4,5,10,15,50
Dominic Turgeon,C,GR,20.553,58,5,5,5,10,15,59
Patrick Russell,RW,BAK,23.696,57,7,3,5,10,15,130
Michael Bournival,LW,SYR,24.293,30,5,5,4,10,14,56
Petr Straka,LW,ALB,24.252,34,5,5,4,10,14,62
Brent Regner,D,SPR,27.332,28,3,7,4,10,14,69
Ryan Bourque,LW,HER,25.699,42,3,7,3,10,13,49
Tim Erixon,D,WBS,25.584,43,3,7,3,10,13,82
Jacob MacDonald,D,ALB,23.551,24,5,5,3,10,13,55
Derek Ryan,C,CHA,29.74,9,5,5,3,10,13,28
Daniel Muzito-Bagenda,LW,RCH,20.249,49,8,2,2,10,12,43
Darren Dietz,D,HER/TEX,23.164,45,6,4,2,10,12,41
Mike McMurtry,C,TEX,21.288,39,6,4,2,10,12,44
Marc-Andre Bergeron,D,CLE,35.923,20,5,5,2,10,12,41
Aaron Palushaj,RW,CLE,27.022,28,3,7,2,10,12,50
Max Novak,C,ALB,25.419,54,6,4,2,10,12,76
Robin Kovacs,LW,HFD,19.83,63,2,8,2,10,12,48
Ben Holmstrom,C,BRI,29.436,64,5,5,2,10,12,77
Kyle Bonis,LW,RCH,27.581,45,8,2,0,10,10,54
Alex Belzile,RW,SA,25.041,36,5,5,0,10,10,65
Rasmus Andersson,D,STK,19.885,50,3,6,13,9,22,87
Zach Leslie,D,ONT,22.622,56,3,6,10,9,19,83
Mirco Mueller,D,SJ,21.488,51,1,8,9,9,18,62
Zach Palmquist,D,IA,25.767,60,2,7,9,9,18,54
Keegan Lowe,D,CHA/STJ,23.466,60,4,5,8,9,17,68
Joel Hanley,D,STJ,25.271,57,2,7,8,9,17,67
Mike Zalewski,C,UTI,24.077,43,4,5,7,9,16,68
Brenden Kichton,D,MB,24.244,53,0,9,7,9,16,70
Colin Campbell,RW,GR,25.414,44,6,3,6,9,15,95
Mike Ribeiro,C,MIL,36.595,18,3,6,6,9,15,26
Karl Stollery,D,ALB,28.816,49,1,8,6,9,15,60
Tanner Glass,LW,HFD,32.795,57,6,3,6,9,15,43
Chad Nehring,C,BNG,29.255,38,5,4,6,9,15,60
Joseph LaBate,LW,UTI,23.416,29,4,5,4,9,13,50
Sam Herr,LW,ONT,23.923,51,7,2,4,9,13,75
Henri Ikonen,LW,SYR,22.414,45,3,6,4,9,13,42
Kellen Jones,LW,BRI,26.082,47,4,5,4,9,13,64
Ryan MacInnis,C,TUC,20.584,57,7,2,3,9,12,59
Jake Dowell,C,RFD,31.534,55,3,6,3,9,12,38
Hunter Smith,RW,STK,21.011,34,3,6,2,9,11,32
Nic Kerdiles,LW,SD,22.677,18,5,4,2,9,11,54
Jeff Hoggan,LW,IA,38.619,52,6,3,2,9,11,81
Juho Lammikko,C,SPR,20.627,47,6,3,2,9,11,63
Austin Carroll,RW,STK,22.474,35,7,2,1,9,10,42
Conner Bleackley,C,CHI,20.603,44,2,7,1,9,10,30
Caleb Herbert,RW,TEX,24.926,26,6,3,1,9,10,37
Patrick Bjorkstrand,C,ONT,24.29,34,8,1,1,9,10,44
Jaedon Descheneau,RW,BAK,21.562,28,4,5,1,9,10,31
Philip Samuelsson,D,STJ/CHA,25.14,51,2,7,1,9,10,53
Derek Army,C,MIL,25.433,29,7,2,0,9,9,42
Oliver Kylington,D,STK,19.326,51,4,4,11,8,19,75
Shea Theodore,D,SD,21.118,21,3,5,10,8,18,72
Anthony DeAngelo,D,TUC,20.893,25,3,5,9,8,17,50
Samuel Morin,D,LV,21.178,62,3,5,8,8,16,91
Ben Thomas,D,SYR,20.301,59,2,6,8,8,16,67
Jon Landry,D,BRI,33.375,48,4,4,8,8,16,67
Patrick McNally,D,SJ,24.781,54,3,5,7,8,15,64
Daniel Walcott,D,SYR,22.57,55,4,4,7,8,15,65
Dan Renouf,D,GR,22.29,56,3,5,6,8,14,47
Justin Kirkland,C,MIL,20.121,49,6,2,6,8,14,58
Jeremy Langlois,RW,RFD,26.288,55,7,1,6,8,14,76
Frank Corrado,D,TOR/WBS,23.474,25,1,7,5,8,13,59
Casey Nelson,D,RCH,24.162,45,4,4,5,8,13,83
Jamie Devane,LW,STK,25.567,32,4,4,4,8,12,37
Jake Dotchin,D,SYR,22.479,33,3,5,4,8,12,54
Keaton Thompson,D,SD,21.003,43,3,5,4,8,12,71
Chris Summers,D,HFD,28.608,62,4,4,4,8,12,68
Scooter Vaughan,D,CHI,27.438,52,6,2,3,8,11,51
Ryan Garbutt,LW,SD,31.093,28,4,4,3,8,11,56
Greg Chase,F,BAK,21.704,42,3,5,3,8,11,55
Brandon Gormley,D,ALB/BNG,24.573,40,3,5,3,8,11,56
Yannick Veilleux,LW,STJ,23.562,42,5,3,2,8,10,42
Daniel Carr,LW,STJ,24.871,15,5,3,2,8,10,40
Kenney Morrison,D,STK,24.586,50,3,5,2,8,10,88
Mackenzie MacEachern,LW,CHI,22.521,47,5,3,2,8,10,60
Colin Blackwell,C,SJ,23.468,48,3,5,2,8,10,66
Anthony Mantha,LW,GR,21.997,10,8,0,2,8,10,34
Gabriel Dumont,C,SYR,25.942,19,5,3,2,8,10,47
Carl Dahlstrom,D,RFD,21.63,60,6,2,2,8,10,89
Tyler Graovac,C,IA,23.386,13,7,1,2,8,10,32
Reid Petryk,LW,SA,23.616,33,5,3,2,8,10,32
Cody Corbett,D,SA,22.753,23,2,6,2,8,10,41
Frederik Gauthier,C,TOR,21.389,35,2,6,1,8,9,39
Cole Cassels,RW,UTI,21.367,55,5,3,1,8,9,59
Jean Dupuy,C,RCH,21.942,33,3,5,1,8,9,42
Louis-Marc Aubry,C,GR,24.844,36,4,4,1,8,9,59
Tye McGinn,LW,SYR,26.132,11,7,1,1,8,9,29
Marc Hagel,RW,IA/BNG,28.036,46,2,6,1,8,9,72
Alex Petan,F,IA/CLE,24.373,19,3,5,0,8,8,30
Ben Thomson,LW,ALB,23.663,63,5,3,0,8,8,101
Kurtis Gabriel,F,IA,23.405,39,7,1,0,8,8,45
Brock McGinn,LW,CHA,22.616,9,5,3,0,8,8,35
Dan Catenacci,C,RCH/HFD,23.521,59,7,0,10,7,17,75
Jeff Schultz,D,SD,30.553,56,0,7,8,7,15,46
Mark Fayne,D,BAK,29.337,29,2,5,8,7,15,34
Ludwig Bystrom,D,TEX,22.156,49,2,5,7,7,14,50
Ian McCoshen,D,SPR,21.112,59,4,3,7,7,14,79
Craig Cunningham,RW,TUC,26.005,11,4,3,6,7,13,27
Julien Brouillette,D,STJ,29.778,46,2,5,6,7,13,60
Mattias Backman,D,TEX/HER,23.951,42,3,4,5,7,12,45
Madison Bowey,D,HER,21.4,27,3,4,5,7,12,59
Patrick Sieloff,D,BNG,22.337,51,2,5,5,7,12,42
Trevor Carrick,D,CHA,22.2,43,3,4,5,7,12,103
Alex Friesen,C,CHI,25.625,65,2,5,4,7,11,66
Maxime Fortunus,D,IA,33.134,52,4,3,4,7,11,62
Denis Malgin,F,SPR,19.658,15,3,4,4,7,11,29
Dakota Mermis,D,TUC,22.693,56,2,5,3,7,10,54
Markus Eisenschmid,C,STJ,21.647,36,6,1,3,7,10,57
Tyson Strachan,D,RCH,31.877,55,1,6,3,7,10,57
Austin Fyten,C,TEX,25.37,52,5,2,3,7,10,52
Brian Lashoff,D,GR,26.167,50,3,4,3,7,10,58
Andrew O'Brien,LW,SD/MIL,23.816,36,2,5,3,7,10,67
Matt Bartkowski,D,PRO,28.282,34,2,5,3,7,10,59
Adam Gilmour,F,IA,22.627,52,4,3,3,7,10,62
Anton Slepyshev,LW,BAK,22.342,9,3,4,3,7,10,31
Andrej Nestrasil,F,CHA,25.562,25,4,3,3,7,10,49
Rinat Valiev,D,TOR,21.348,37,2,5,2,7,9,60
Mark Alt,D,LV,24.91,29,1,6,2,7,9,24
Maxim Lamarche,D,LV,24.181,17,4,3,2,7,9,17
Ty Loney,RW,ALB/CHI,24.542,18,4,3,2,7,9,35
Ryan Olsen,C,MB,22.477,47,6,1,2,7,9,51
Nick Schmaltz,RW,RFD,20.559,12,6,1,2,7,9,32
Nick Tarnasky,LW,SD,31.805,31,4,3,2,7,9,39
Michael Paliotta,D,HFD,23.444,40,1,6,2,7,9,78
Josh Brown,D,SPR,22.649,61,2,5,2,7,9,42
Andrey Pedan,D,UTI,23.203,41,4,3,1,7,8,77
Vaclav Karabacek,RW,RCH,20.373,23,3,4,1,7,8,25
Hudson Fasching,RW,RCH,21.134,25,6,1,1,7,8,43
Mike Weber,D,IA,28.748,55,1,6,1,7,8,60
Zac Rinaldo,LW,PRO,26.252,29,5,2,0,7,7,34
Tyler Barnes,RW,RFD,26.586,25,4,3,0,7,7,24
Petteri Lindbohm,D,CHI,22.978,43,6,0,8,6,14,59
David Musil,D,BAK/TUC,23.436,53,4,2,7,6,13,54
Tyler Lewington,D,HER,21.778,61,2,4,7,6,13,58
Cameron Gaunce,D,WBS,26.493,49,2,4,7,6,13,71
Michael Chaput,C,UTI,24.436,10,2,4,7,6,13,18
Nelson Nogier,D,MB,20.304,57,2,4,7,6,13,84
Mike Sgarbossa,C,SD/SPR,24.142,16,5,1,7,6,13,29
Rob O'Gara,D,PRO,23.195,47,4,2,6,6,12,42
Anton Lindholm,D,SA,21.795,59,2,4,6,6,12,48
Zach Redmond,D,STJ,28.14,18,2,4,5,6,11,44
Viktor Svedberg,D,RFD,25.312,51,2,4,5,6,11,106
Dennis Robertson,D,CHA,25.312,51,4,2,5,6,11,65
Austin Czarnik,C,PRO,23.759,10,3,3,4,6,10,22
Richard Clune,LW,TOR,29.392,33,3,3,3,6,9,20
Barry Goers,D,WBS,30.255,31,3,3,3,6,9,41
Reid McNeill,D,WBS/CHI,24.381,57,3,3,3,6,9,65
Mathieu Brodeur,D,SYR,26.236,44,3,3,3,6,9,50
Brandon Tanev,LW,MB,24.707,23,3,3,3,6,9,49
Jesse Graham,D,BRI,22.342,17,2,4,3,6,9,36
Mike Downing,D,SPR,21.326,55,2,4,3,6,9,94
Sam Henley,C,SA,23.142,55,3,3,3,6,9,46
Steve Oleksy,D,WBS/TOR,30.611,25,2,4,2,6,8,40
William Wrenn,D,TOR,25.501,36,2,4,2,6,8,38
Patrick Mullen,D,RCH,30.362,18,3,3,2,6,8,26
Julian Melchiori,D,MB,24.775,40,2,4,2,6,8,89
Evan Mosey,RW,RFD,27.499,35,4,2,2,6,8,55
Julien Nantel,C,SA,21.025,52,5,1,2,6,8,62
Eric Selleck,RW,TUC,28.904,35,4,2,1,6,7,49
David Broll,LW,STJ,23.696,49,5,1,1,6,7,43
Tony Cameranesi,F,TOR,23.093,28,4,2,1,6,7,55
Cameron Darcy,C,SYR,22.54,34,3,3,1,6,7,40
Gustav Forsling,D,RFD,20.26,25,1,5,1,6,7,52
Ondrej Kase,RW,SD,20.852,9,3,3,1,6,7,28
Michael Joly,RW,HFD,21.364,24,2,4,1,6,7,17
Brody Sutter,C,SPR,24.97,19,3,3,1,6,7,28
Jere Sallinen,LW,BAK,25.888,48,4,2,1,6,7,60
Shawn Ouellette-St. Amant,LW,SA,19.825,20,3,3,1,6,7,27
Jarrett Burton,C,WBS,25.71,28,4,2,0,6,6,26
Vinnie Hinostroza,C,RFD,22.452,12,3,3,0,6,6,29
Miles Wood,LW,ALB,21.005,14,3,3,0,6,6,41
Scott Mayfield,D,BRI,23.921,23,3,3,0,6,6,54
Sergei Boikov,D,SA,20.641,54,3,2,11,5,16,79
Tyler Wotherspoon,D,STK,23.512,46,4,1,9,5,14,55
Chris Casto,D,PRO,24.718,52,1,4,7,5,12,71
Brian Strait,D,MB,28.696,50,2,3,7,5,12,74
Jimmy Oligny,D,MIL,23.378,64,1,4,6,5,11,86
David Shields,D,UTI,25.633,46,0,5,5,5,10,42
Yohann Auvitu,D,ALB,27.137,22,3,2,5,5,10,61
Matt MacKenzie,D,SPR,24.918,31,4,1,5,5,10,54
Roland McKeown,D,CHA,20.652,57,1,4,5,5,10,101
Brooks Laich,C,TOR,33.23,27,1,4,4,5,9,23
Tom Gilbert,D,ONT/HER,33.679,20,1,4,4,5,9,21
Brady Austin,D,RCH,23.249,61,2,3,4,5,9,66
Josh Jacobs,D,ALB,20.581,44,0,5,4,5,9,54
Dillon Simpson,D,BAK,23.595,42,3,2,4,5,9,50
Branden Troock,RW,TEX/TUC,22.49,26,2,3,3,5,8,40
Stuart Percy,D,WBS,23.329,37,1,4,3,5,8,43
Graham Black,C,SPR,23.671,31,4,1,3,5,8,32
Kyle Platzer,C,BAK,21.534,49,1,4,3,5,8,55
Tom Parisi,D,STJ,23.17,42,1,4,2,5,7,52
Kelly Zajac,C,HER,28.277,9,4,1,2,5,7,9
Keith Aulie,D,CLE/STK,27.263,48,2,3,2,5,7,34
Mike Liambas,LW,MIL,27.578,60,3,2,2,5,7,50
Jan Kostalek,D,MB,21.575,51,2,3,2,5,7,65
Eric Robinson,F,MIL/SPR,26.315,41,1,4,2,5,7,37
Andreas Englund,D,BNG,20.649,57,2,3,2,5,7,34
Matt Tennyson,D,CHA,26.397,9,3,2,2,5,7,29
Dylan Sadowy,RW,GR,20.455,31,4,1,1,5,6,39
Blake Siebenaler,D,CLE,20.548,41,3,2,1,5,6,60
Ben Marshall,D,PRO,24.044,13,2,3,1,5,6,24
Pierre-Cedric Labrie,LW,RFD,30.26,45,0,5,1,5,6,66
Zac Larraza,LW,SD,23.553,15,4,1,1,5,6,11
Luke Gazdic,LW,ALB,27.142,31,1,4,1,5,6,28
Ryan Rupert,C,BNG,22.288,33,3,2,1,5,6,39
Derek Hulak,LW,UTI,27.036,17,4,1,0,5,5,16
Jon Martin,RW,SJ,21.063,25,2,3,0,5,5,21
Kevin Lynch,C,SYR,25.397,25,3,2,0,5,5,36
Zac Dalpe,RW,IA/CLE,26.871,19,3,2,0,5,5,53
Nic Petan,C,MB,21.485,9,4,1,0,5,5,20
Malte Stromwall,RW,HFD,22.06,35,1,4,0,5,5,47
Slater Koekkoek,D,SYR,22.573,38,2,2,7,4,11,78
Hubert Labrie,D,HER,25.178,59,2,2,6,4,10,37
Brandon Burlon,D,TUC,26.532,29,2,2,5,4,9,18
Mac Bennett,D,RCH,25.477,45,3,1,5,4,9,53
Conor Allen,D,GR,26.622,47,1,3,5,4,9,39
Ryan Stanton,D,SA/CLE,27.156,36,2,2,5,4,9,48
Tyler Randell,RW,PRO,25.252,52,0,4,5,4,9,47
Conor Garland,RW,TUC,20.515,44,2,2,4,4,8,67
James Wisniewski,D,CHI,32.564,10,4,0,4,4,8,18
Nate Guenin,D,SD,33.764,47,2,2,4,4,8,53
Seth Helgeson,D,ALB,25.937,37,2,2,4,4,8,39
Cody Goloubef,D,CLE/SA,26.792,18,2,2,4,4,8,40
Mitch Moroz,LW,BAK/TUC,22.37,32,3,1,3,4,7,26
Anthony Duclair,RW,TUC,21.055,16,1,3,3,4,7,26
Reece Willcox,D,LV,22.49,42,3,1,3,4,7,35
Paul Geiger,D,RCH,24.134,44,2,2,3,4,7,45
Dan Kelly,D,SJ,27.332,44,1,3,3,4,7,35
Brian Hart,RW,SYR,22.805,33,3,1,3,4,7,50
Nolan Valleau,D,RFD,23.833,40,2,2,3,4,7,61
Hunter Warner,D,IA,20.984,44,2,2,3,4,7,24
Matt Lashoff,D,SA,29.962,19,3,1,3,4,7,21
Alex Krushelnyski,LW,BNG,25.836,43,3,1,3,4,7,39
Erik Karlsson,LW,CHA,22.134,42,0,4,3,4,7,32
Reid Gardiner,RW,WBS,20.655,23,3,1,2,4,6,31
Marco Roy,C,UTI,21.86,21,1,3,2,4,6,21
Alex Lintuniemi,D,ONT,20.978,32,1,3,2,4,6,27
Nick Jensen,D,GR,25.984,27,1,3,2,4,6,44
Adam Pardy,D,MIL,32.466,24,2,2,2,4,6,26
Logan Shaw,RW,SPR/SD,23.945,15,4,0,2,4,6,34
Viktor Loov,D,TOR/ALB,23.83,45,2,2,2,4,6,45
Nick Saracino,LW,IA,24.567,32,2,2,2,4,6,38
Colin Markison,RW,BRI,24.11,26,2,2,2,4,6,27
Duncan Siemens,D,SA,23.022,64,2,2,2,4,6,62
Brendan Woods,LW,CHA,24.263,16,3,1,2,4,6,26
William Carrier,LW,RCH,21.737,8,3,1,1,4,5,13
Reid Boucher,LW,MIL,23.019,5,4,0,1,4,5,13
Akim Aliu,RW,CLE,27.395,13,3,1,1,4,5,20
Brett Gallant,LW,CLE,27.715,43,3,1,1,4,5,37
Chris DeSousa,C,RFD,25.907,34,4,0,1,4,5,51
Joey Benik,LW,BAK,24.636,21,4,0,1,4,5,37
Clark Bishop,C,CHA,20.466,32,2,2,1,4,5,34
Emerson Clark,LW,CHI/UTI,23.745,12,2,2,0,4,4,5
Justin Kea,C,RCH,22.603,12,2,2,0,4,4,9
Daniel Ciampini,LW,ONT,25.805,19,1,3,0,4,4,22
Pavel Buchnevich,RW,HFD,21.414,4,2,2,0,4,4,9
Ahti Oksanen,LW,HFD,23.518,15,2,2,0,4,4,21
Greg McKegg,C,SPR,24.247,7,2,2,0,4,4,9
Braden Christoffer,LW,BAK,22.121,40,2,2,0,4,4,33
Curtis Lazar,C,BNG,21.616,13,3,1,0,4,4,30
Ethan Prow,D,WBS,23.827,49,1,2,11,3,14,59
Dillon Heatherington,D,CLE/TEX,21.353,47,1,2,6,3,9,88
Jack Dougherty,D,MIL,20.31,63,1,2,6,3,9,58
Brett Kulak,D,STK,22.69,16,2,1,5,3,8,29
Robin Norell,D,RFD,21.573,55,1,2,4,3,7,35
Mat Clark,D,SA,25.912,28,1,2,4,3,7,26
Jarred Tinordi,D,TUC,24.567,54,1,2,3,3,6,66
Matt Bailey,C,STK,25.447,17,2,1,3,3,6,24
Dustin Stevenson,D,TEX,27.093,54,2,1,3,3,6,60
Dylan McIlrath,D,HFD/SPR/GR,24.405,31,1,2,3,3,6,37
Stu Bickel,RW,SD,29.953,19,2,1,3,3,6,22
Anthony Camara,LW,STJ,23.03,17,2,1,2,3,5,19
Pierre-Luc Letourneau-Leblond,LW,SYR/TOR,31.282,38,1,2,2,3,5,21
Milan Michalek,LW,TOR,31.773,16,2,1,2,3,5,25
Mikkel Aagaard,C,STK,20.91,14,2,1,2,3,5,17
John Negrin,D,UTI,27.477,20,0,3,2,3,5,18
Mike Aviani,C,RCH,23.441,13,2,1,2,3,5,11
Jacob Middleton,D,SJ,20.701,39,1,2,2,3,5,37
Luke Witkowski,D,SYR,26.422,19,0,3,2,3,5,24
Brian Cooper,D,SD,22.871,29,2,1,2,3,5,32
Josh Holmstrom,C,BRI,27.027,57,2,1,2,3,5,55
Sam Jardine,D,SA,23.093,27,3,0,2,3,5,32
Lindsay Sparks,F,TUC,26.104,22,1,2,1,3,4,15
Garret Ross,LW,TUC,24.307,27,1,2,1,3,4,33
Cody Bass,C,MIL,29.688,13,2,1,1,3,4,19
Jonathan Diaby,D,MIL,21.83,21,2,1,1,3,4,15
Dominik Masin,D,SYR,20.619,57,2,1,1,3,4,48
Austen Brassard,RW,SD,23.668,20,2,1,1,3,4,15
Adam Pelech,D,BRI,22.082,11,1,2,1,3,4,22
Joe Diamond,F,SPR,27.249,7,1,2,1,3,4,6
Stephen MacAulay,C,SPR,24.405,28,2,1,1,3,4,26
Nikita Soshnikov,RW,TOR,22.921,6,1,2,0,3,3,11
Brendan Gaunce,LW,UTI,23.477,4,2,1,0,3,3,15
Jayson Megna,RW,UTI,26.619,4,1,2,0,3,3,3
Stephen Johns,D,TEX,24.411,2,3,0,0,3,3,5
Rob Scuderi,D,ONT,37.71,15,0,3,0,3,3,4
Drew Miller,LW,GR,32.575,7,2,1,0,3,3,8
Justin Hickman,RW,PRO,22.496,24,2,1,0,3,3,22
Stephen Gionta,C,BRI,32.934,7,1,2,0,3,3,11
Zac Lynch,LW,SPR,24.504,14,2,1,0,3,3,13
Henrik Samuelsson,LW,TUC/BAK,22.603,25,2,1,0,3,3,20
Greger Hanson,RW,SD/CHI/BNG/CHA,28.575,11,1,2,0,3,3,23
Jakub Kindl,D,SPR,29.595,13,1,1,5,2,7,25
Josiah Didier,D,STJ,23.438,28,1,1,4,2,6,28
Lukas Bengtsson,D,WBS,22.422,16,1,1,4,2,6,25
Joel Lowry,LW,ONT,24.833,30,0,2,4,2,6,21
Dylan Blujus,D,SYR,22.647,15,1,1,4,2,6,35
Brodie Dupont,C,BAK,29.575,11,1,1,4,2,6,15
Andrew Copp,C,MB,22.189,8,0,2,3,2,5,13
Andrew MacWilliam,D,ALB,26.477,56,0,2,3,2,5,57
Bryce Aneloski,D,BAK,26.386,35,1,1,3,2,5,25
Hunter Fejes,LW,TUC,22.293,17,1,1,2,2,4,14
Derek Grant,C,RCH,26.405,10,1,1,2,2,4,26
Justin Vaive,LW,RCH,27.189,53,2,0,2,2,4,45
Stefan Fournier,RW,TUC/SYR,24.378,32,2,0,2,2,4,29
Adam Chapie,RW,HFD,25.195,22,0,2,2,2,4,6
Allan McPherson,C,HFD,25.438,28,1,1,2,2,4,17
Kyle Hagel,LW,CHA,31.649,24,1,1,2,2,4,13
Kevin Connauton,D,TUC,26.559,2,1,1,1,2,3,6
Trevor Cheek,LW,TUC,23.712,20,0,2,1,2,3,16
Eric Faille,RW,TOR,27.137,11,1,1,1,2,3,14
Chris McCarthy,F,LV,25.129,13,1,1,1,2,3,8
Domenic Monardo,LW,HER,27.942,11,0,2,1,2,3,8
Patrick McGrath,RW,WBS,23.499,24,0,2,1,2,3,11
Zack Stortini,RW,BNG/SJ,31.011,40,2,0,1,2,3,27
Michael Brodzinski,D,SJ,21.301,9,0,2,1,2,3,13
Mike Borkowski,C,GR,24.397,39,2,0,1,2,3,33
Stephen Perfetto,C,SA/MIL,25.123,8,1,1,1,2,3,7
Kenny Ryan,RW,SD,25.184,8,2,0,1,2,3,15
Loic Leduc,D,BRI,22.255,33,1,1,1,2,3,40
Rihards Bukarts,LW,SPR,20.707,14,0,2,1,2,3,15
Ben Betker,D,BAK,21.962,20,1,1,1,2,3,15
Turner Elson,C,SA,24.005,10,1,1,1,2,3,18
Guillaume Lepine,D,BNG,29.526,50,1,1,1,2,3,57
Bryan Bickell,LW,CHA,30.521,6,0,2,1,2,3,1
Dysin Mayo,D,TUC,20.079,14,1,1,0,2,2,16
Daniel Maggio,RW,TOR,25.534,4,1,1,0,2,2,5
Ty Rattie,RW,CHI,23.608,13,1,1,0,2,2,33
Justin Selman,F,CHI,22.953,17,1,1,0,2,2,13
Kevin Gravel,D,ONT,24.529,6,0,2,0,2,2,6
Tomas Jurco,LW,GR,23.715,2,1,1,0,2,2,7
Matt Caito,D,GR,23.09,13,1,1,0,2,2,20
John Kurtz,LW,SYR,27.334,7,2,0,0,2,2,9
Jacob Graves,D,CLE,21.468,19,1,1,0,2,2,12
Frank Vatrano,C,PRO,22.507,2,2,0,0,2,2,8
Darcy Murphy,LW,MB,24.06,8,1,1,0,2,2,12
Kyle MacKinnon,C,SD,28.882,15,1,1,0,2,2,17
Greg Wolfe,C,ALB,26.392,5,1,1,0,2,2,6
Gerald Mayhew,RW,IA,23.707,4,2,0,0,2,2,7
A.J. Jenks,F,IA,26.219,6,1,1,0,2,2,10
Scott Czarnowczan,D,IA,25.299,11,0,2,0,2,2,4
Matt Leitner,C,SPR,25.8,8,0,2,0,2,2,6
Mikko Rantanen,LW,SA,19.879,4,0,2,0,2,2,7
Alexx Privitera,D,ONT,23.658,14,0,1,3,1,4,23
Alex Schoenborn,RW,SJ,20.759,25,1,0,3,1,4,21
Petter Granberg,D,MIL,24.052,39,1,0,3,1,4,21
Jonathan Racine,D,STJ/SYR,23.301,45,0,1,3,1,4,28
Nick Seeler,D,IA,23.285,44,0,1,3,1,4,31
Eric Gelinas,D,SA,25.356,15,0,1,3,1,4,30
Marc-Andre Cliche,C,TOR,29.482,16,1,0,2,1,3,18
Joey Leach,D,HER,24.627,18,0,1,2,1,3,8
Tom Nilsson,D,UTI,23.074,17,0,1,2,1,3,10
Patrik Nemeth,D,TEX,24.6,4,1,0,2,1,3,7
Devin Setoguchi,RW,ONT,29.704,9,0,1,2,1,3,10
Anthony Bitetto,D,MIL,26.17,3,1,0,2,1,3,8
Taylor Doherty,D,PRO,25.54,10,0,1,2,1,3,9
Garrett Noonan,D,HFD,25.63,23,0,1,2,1,3,17
Calle Andersson,D,HFD,22.334,4,0,1,2,1,3,7
Patrick Cullity,D,BRI,29.636,28,0,1,2,1,3,20
Mark Fraser,D,BAK,29.962,54,0,1,2,1,3,44
Gus Young,D,CHI/SA,25.184,19,0,1,2,1,3,12
Mitchell Heard,C,CHA,24.512,35,0,1,2,1,3,37
Alexandre Ranger,RW,SA/STJ,21.077,15,1,0,1,1,2,11
Steve Weinstein,D,HER,26.09,5,0,1,1,1,2,1
Kayle Doetzel,D,STK,21.241,49,0,1,1,1,2,29
Kevin Tansey,D,CHI,23.562,17,1,0,1,1,2,13
Brady Vail,C,RCH,22.515,18,1,0,1,1,2,9
Matthew Lane,C,RCH,22.504,15,0,1,1,1,2,10
Justin Hache,D,TUC/TEX,22.679,17,0,1,1,1,2,16
Bryce Van Brabant,LW,TEX,24.841,21,1,0,1,1,2,20
Damir Sharipzianov,D,ONT,20.575,30,0,1,1,1,2,16
Zach Trotman,D,ONT,26.055,9,0,1,1,1,2,8
Alex Gallant,LW,SJ,23.77,25,0,1,1,1,2,14
Blake Kessel,D,MIL,27.425,8,0,1,1,1,2,5
David Pacan,RW,SYR,25.46,6,0,1,1,1,2,4
Kyle Thomas,RW,CLE,26.622,12,1,0,1,1,2,14
Joe Devin,LW,SA/CLE,28.945,20,1,0,1,1,2,16
Dalton Prout,D,CLE,26.51,7,0,1,1,1,2,9
Bryan Moore,F,SJ/MB,22.31,4,1,0,1,1,2,7
Anthony Peluso,RW,MB,27.411,22,0,1,1,1,2,26
Darren Kramer,LW,MB,24.822,31,1,0,1,1,2,21
Marko Dano,LW,MB,21.792,6,0,1,1,1,2,12
Nolan Zajac,D,HER/MB/IA,24.123,7,1,0,1,1,2,4
Dylan Labbe,D,IA,21.682,15,0,1,1,1,2,6
Ed Wittchow,D,SPR,23.874,26,1,0,1,1,2,22
Thomas Schemitsch,D,SPR,19.888,29,0,1,1,1,2,20
Zach Pochiro,C,BAK,22.529,4,0,1,1,1,2,3
Matt Benning,D,BAK,22.31,2,1,0,1,1,2,8
Trent Vogelhuber,LW,SA,28.175,15,0,1,1,1,2,18
Vincent Dunn,LW,BNG,21.003,8,0,1,1,1,2,3
Brenden Miller,D,TOR,22.466,2,1,0,0,1,1,3
Mason Marchment,LW,TOR,21.244,9,1,0,0,1,1,11
Tyrell Goulbourne,LW,LV,22.636,15,1,0,0,1,1,11
Zach Aston-Reese,RW,WBS,22.099,1,1,0,0,1,1,4
Thomas Di Pauli,C,WBS,22.381,15,1,0,0,1,1,14
Adam Krause,C,WBS,25.008,5,0,1,0,1,1,7
Jacob Doty,RW,CHI,23.241,4,0,1,0,1,1,1
Anton Rodin,F,UTI,25.816,3,0,1,0,1,1,3
Phil DeSimone,C,UTI,29.493,8,1,0,0,1,1,15
Yan-Pavel Laplante,LW,UTI,21.397,13,0,1,0,1,1,7
Troy Stecher,D,UTI,22.441,4,0,1,0,1,1,8
Gavin Bayreuther,D,TEX,22.345,2,1,0,0,1,1,3
Rick Pinkston,D,MIL,25.948,15,0,1,0,1,1,7
Miikka Salomaki,LW,MIL,23.521,4,1,0,0,1,1,5
Matt Irwin,D,MIL,28.795,4,0,1,0,1,1,16
Austin Watson,C,MIL,24.671,3,1,0,0,1,1,4
Mike McNamee,C,SYR,23.896,9,0,1,0,1,1,8
Cory Ward,C,SYR,23.397,2,0,1,0,1,1,2
Brandon Alderson,RW,HFD/SYR,24.647,11,0,1,0,1,1,11
Miles Koules,F,ONT/CLE,22.225,6,1,0,0,1,1,4
Shawn Szydlowski,RW,CLE,26.112,7,1,0,0,1,1,6
Dante Salituro,RW,CLE,19.833,5,1,0,0,1,1,4
Frank Hora,D,CLE,20.29,3,0,1,0,1,1,1
Joe Morrow,D,PRO,23.767,3,1,0,0,1,1,8
Mark Naclerio,C,PRO,24.449,7,1,0,0,1,1,7
Jake Kulevich,D,MB,23.586,1,0,1,0,1,1,1
Kale Kessy,LW,MB,23.781,12,0,1,0,1,1,3
Luc Snuggerud,D,RFD,20.992,2,0,1,0,1,1,2
Nate Thompson,C,SD,31.945,3,0,1,0,1,1,6
Emerson Etem,RW,SD,24.249,1,1,0,0,1,1,2
Michael Sdao,D,IA,27.203,2,1,0,0,1,1,2
Ryan Carter,F,IA,33.118,9,0,1,0,1,1,13
Joel Eriksson Ek,C,IA,23.627,1,1,0,0,1,1,2
Darren Nowick,C,BRI,24.899,4,1,0,0,1,1,4
Iiro Pakarinen,RW,BAK,25.058,5,0,1,0,1,1,10
Fredrik Claesson,D,BNG,23.808,9,0,1,0,1,1,8
Cason Hohmann,RW,CHA,23.679,2,0,1,0,1,1,3
Josh Wesley,D,CHA,20.436,9,1,0,0,1,1,14
Ashton Sautner,D,UTI,22.304,36,0,0,4,0,4,31
Brandon Anselmini,D,TEX,23.433,10,0,0,3,0,3,18
Paul Bissonnette,LW,ONT,31.515,17,0,0,3,0,3,15
Oleg Yevenko,D,CLE,25.649,37,0,0,3,0,3,25
Gabriel Gagne,RW,BNG,19.844,29,0,0,3,0,3,34
Sergey Kalinin,C,TOR,25.499,11,0,0,2,0,2,4
Keegan Kanzig,D,STK,21.551,6,0,0,2,0,2,3
Paul Bittner,C,CLE,19.863,31,0,0,2,0,2,32
Chris Breen,D,PRO,27.214,31,0,0,2,0,2,32
A.J. White,LW,PRO,24.408,12,0,0,2,0,2,8
Jacob Larsson,D,SD,19.381,4,0,0,2,0,2,9
Spiro Goulakos,D,HFD,26.578,8,0,0,2,0,2,8
Tommy Hughes,D,HFD,24.441,41,0,0,2,0,2,32
Brett Stern,D,WBS,24.54,9,0,0,1,0,1,14
Steve McParland,RW,CHI,25.586,3,0,0,1,0,1,2
Jared Nightingale,D,CHI,33.951,11,0,0,1,0,1,5
Esa Lindell,D,TEX,22.315,2,0,0,1,0,1,4
Zach Nastasiuk,RW,GR,21.463,4,0,0,1,0,1,2
Sheldon Brookbank,D,CLE,35.951,6,0,0,1,0,1,3
Linus Arnesson,D,PRO,21.984,18,0,0,1,0,1,19
Jake Baker,D,MB,25.162,13,0,0,1,0,1,8
Brian Ward,LW,ALB,24.584,8,0,0,1,0,1,4
Eric Boulton,LW,BRI,40.079,2,0,0,1,0,1,2
Kyle Schempp,C,BRI,22.671,11,0,0,1,0,1,9
Frankie Simonelli,D,BAK,23.879,6,0,0,1,0,1,7
Mason Geertsen,D,SA,21.408,27,0,0,1,0,1,13
Macoy Erkamps,D,BNG,21.616,4,0,0,1,0,1,3
Klas Dahlbeck,D,CHA,25.195,6,0,0,1,0,1,14
Ryan Murphy,D,CHA,23.46,7,0,0,1,0,1,9
Mark Cooper,F,TUC,24.307,5,0,0,0,0,0,3
Matia Marcantuoni,C,TUC,22.562,7,0,0,0,0,0,2
John McCarron,RW,STJ,24.416,3,0,0,0,0,0,5
Brandon MacLean,LW,STJ,29.03,2,0,0,0,0,0,2
Connor Crisp,LW,STJ,22.438,7,0,0,0,0,0,8
Shane Conacher,RW,TOR,22.395,3,0,0,0,0,0,2
Alex Gudbranson,D,TOR,22.033,4,0,0,0,0,0,2
Nikolas Brouillard,D,TOR,21.603,1,0,0,0,0,0,3
Willie Corrin,D,TOR,25.123,4,0,0,0,0,0,2
Ty Stanton,D,TOR,21.315,3,0,0,0,0,0,1
Josh Leivo,LW,TOR,23.307,5,0,0,0,0,0,11
Boyd Gordon,F,LV,32.907,6,0,0,0,0,0,6
Steven Swavely,RW,LV,24.781,14,0,0,0,0,0,9
Hampus Gustafsson,C,HER,22.888,2,0,0,0,0,0,3
Justin Agosta,D,SA/ALB/HER,25.934,3,0,0,0,0,0,1
Dustin Gazley,RW,HER,27.951,1,0,0,0,0,0,3
Troy Josephs,C,WBS,22.353,2,0,0,0,0,0,1
Christian Hilbrich,LW,WBS,24.186,5,0,0,0,0,0,3
Ryan Culkin,D,STK,22.751,19,0,0,0,0,0,25
Tage Thompson,C,CHI,18.877,5,0,0,0,0,0,5
Josh Atkinson,D,CHI,23.942,2,0,0,0,0,0,2
Josh Brittain,LW,CHI,26.699,2,0,0,0,0,0,1
Alex Wall,D,UTI,25.871,2,0,0,0,0,0,2
Alex Biega,D,UTI,28.449,1,0,0,0,0,0,0
Luke Pither,C,UTI,27.389,1,0,0,0,0,0,1
Alex Kile,LW,RCH,22.186,1,0,0,0,0,0,2
Jordan Henry,D,RCH,30.592,1,0,0,0,0,0,0
Bobby Shea,D,RCH,26.156,10,0,0,0,0,0,5
Eric Baier,D,RCH,28.474,2,0,0,0,0,0,0
Brycen Martin,D,RCH,20.353,9,0,0,0,0,0,5
Tyson Fawcett,RW,RCH,23.271,2,0,0,0,0,0,0
Justin Falk,D,RCH,27.929,10,0,0,0,0,0,5
Aaron Harstad,D,TEX,24.386,2,0,0,0,0,0,0
Brendan O'Donnell,F,TEX,24.225,6,0,0,0,0,0,1
Joe Faust,D,TEX,24.833,4,0,0,0,0,0,3
Travis Ewanyk,C,TEX,23.466,1,0,0,0,0,0,0
Craig Wyszomirski,D,ONT,23.984,3,0,0,0,0,0,2
Quentin Shore,C,ONT,22.31,7,0,0,0,0,0,5
Travis Brown,D,SJ,22.504,1,0,0,0,0,0,0
Jason Fram,D,SJ,21.397,2,0,0,0,0,0,2
Matt Willows,RW,SJ,25.145,1,0,0,0,0,0,0
Harrison Ruopp,D,SJ,23.499,3,0,0,0,0,0,0
Jake Marchment,C,SJ,21.323,4,0,0,0,0,0,2
Dominik Shine,F,GR,23.411,1,0,0,0,0,0,2
Tyler Kelleher,RW,MIL,21.701,2,0,0,0,0,0,3
Garrett Meurs,RW,MIL,23.674,1,0,0,0,0,0,1
Shawn O'Donnell,RW,MIL,28.301,6,0,0,0,0,0,7
Daniel Doremus,RW,SYR,24.899,1,0,0,0,0,0,1
Kevin Morris,LW,SYR,23.775,2,0,0,0,0,0,1
Olivier Labelle,RW,SYR,31.17,6,0,0,0,0,0,3
Sam Vigneault,C,CLE,21.022,3,0,0,0,0,0,4
Mike Brown,RW,CLE,31.227,11,0,0,0,0,0,10
Scott Harrington,D,CLE,23.518,2,0,0,0,0,0,4
Spencer Asuchak,LW,PRO,24.814,3,0,0,0,0,0,2
Brock Higgs,C,PRO,24.367,2,0,0,0,0,0,1
Brian Ferlin,RW,PRO,24.285,2,0,0,0,0,0,2
Shane Bakker,C,PRO,28.844,2,0,0,0,0,0,2
Jiri Fronk,RW,MB,22.603,1,0,0,0,0,0,2
Jordan Hill,D,MB,27.523,6,0,0,0,0,0,4
Anthony Louis,C,RFD,21.595,2,0,0,0,0,0,6
Robin Press,D,RFD,21.734,6,0,0,0,0,0,10
Nick Mattson,D,RFD,24.89,2,0,0,0,0,0,0
Jonathan Carlsson,D,RFD,28.112,2,0,0,0,0,0,2
Bryn Chyzyk,LW,RFD,23.86,2,0,0,0,0,0,5
Nick Sorkin,RW,SD,25.285,5,0,0,0,0,0,2
Brandon McNally,LW,SD,24.6,2,0,0,0,0,0,2
Joseph Cramarossa,C,SD,23.888,2,0,0,0,0,0,2
Tylor Spink,C,MIL/ALB,23.707,4,0,0,0,0,0,4
Steven Santini,D,ALB,21.526,15,0,0,0,0,0,16
Tommy Thompson,RW,HFD,25.923,3,0,0,0,0,0,3
Jack Nevins,LW,IA,22.992,1,0,0,0,0,0,2
Nolan La Porte,RW,IA,24.367,1,0,0,0,0,0,0
Tyler Sikura,C,IA,24.329,15,0,0,0,0,0,20
Chase Lang,RW,IA,20.005,1,0,0,0,0,0,0
Guillaume Gelinas,D,IA,23.255,1,0,0,0,0,0,0
Justin Danforth,C,BRI,23.504,1,0,0,0,0,0,0
Brant Harris,RW,BRI,26.937,3,0,0,0,0,0,4
Rocco Carzo,F,BRI,26.208,1,0,0,0,0,0,0
Matt Finn,D,BRI,22.556,2,0,0,0,0,0,3
Colton Saucerman,D,HER/SPR,24.364,2,0,0,0,0,0,3
Tony Turgeon,LW,SPR,26.984,6,0,0,0,0,0,4
Teddy Doherty,D,SPR,22.392,1,0,0,0,0,0,0
Jordan Smotherman,LW,SPR,30.348,5,0,0,0,0,0,9
Mikael Tam,D,BAK,25.389,2,0,0,0,0,0,3
Kellan Lain,C,BAK,27.096,2,0,0,0,0,0,0
Joel Rechlicz,RW,BAK,29.255,15,0,0,0,0,0,9
Justin Hamonic,D,SA,22.584,1,0,0,0,0,0,0
Thomas Frazee,C,SA,26.46,3,0,0,0,0,0,0
Jesse Mychan,LW,SA,24.205,5,0,0,0,0,0,7
Chris LeBlanc,RW,BNG,23.008,4,0,0,0,0,0,0
Mike Cazzola,LW,BNG,25.523,3,0,0,0,0,0,1
Jamie Doornbosch,D,BNG,26.619,8,0,0,0,0,0,6
Alexis Loiseau,C,BNG,22.677,3,0,0,0,0,0,2
Triston Grant,LW,BNG,32.616,1,0,0,0,0,0,0
Tyler Ganly,D,CHA,22.485,2,0,0,0,0,0,0
Kevin Raine,D,CHA,23.301,13,0,0,0,0,0,8