#,PLAYER,TEAM,GP,G,A,TP,PPG,PIM,Plus/Minus
1,Brendan Shinnimin(C),Tri-City Americans,69,58,76,134,1.94,82,45
2,Adam Hughesman(LW),Tri-City Americans,72,50,66,116,1.61,42,40
3,Justin Maylan(C),Prince Albert Raiders,72,26,63,89,1.24,62,-6
4,Justin Feser(C/LW),Tri-City Americans,72,37,46,83,1.15,43,17
5,Taylor Vause(C),Swift Current Broncos,72,37,46,83,1.15,12,-1
6,Cameron Braes(C),totals,74,41,41,82,1.11,80,-6
,,Lethbridge Hurricanes,44,24,21,45,1.02,54,-12
,,Moose Jaw Warriors,30,17,20,37,1.23,26,6
7,Brenden Walker(RW),Brandon Wheat Kings,68,26,55,81,1.19,61,16
8,Dylan Wruck(LW/C),Edmonton Oil Kings,66,21,59,80,1.21,17,35
9,T.J. Foster(C/RW),Edmonton Oil Kings,69,31,45,76,1.1,26,38
10,Anthony Bardaro(C),totals,63,36,38,74,1.17,33,-11
,,Spokane Chiefs,29,18,19,37,1.28,17,3
,,Prince Albert Raiders,34,18,19,37,1.09,16,-14
11,Tyler Maxwell(C/D),totals,66,37,34,71,1.08,42,32
,,Everett Silvertips,19,11,3,14,0.74,17,-5
,,Edmonton Oil Kings,47,26,31,57,1.21,25,37
12,James Henry(LW),totals,69,16,55,71,1.03,96,1
,,Vancouver Giants,41,6,35,41,1,50,-4
,,Moose Jaw Warriors,28,10,20,30,1.07,46,5
13,Brandon Herrod(RW),totals,68,29,41,70,1.03,25,-6
,,Prince Albert Raiders,40,18,18,36,0.9,10,-14
,,Kamloops Blazers,28,11,23,34,1.21,15,8
14,Cody Sylvester(C/LW),Calgary Hitmen,66,23,45,68,1.03,76,27
15,Jamie Crooks(LW),Victoria Royals,72,37,30,67,0.93,32,-18
16,Brady Brassart(C/RW),Calgary Hitmen,70,25,34,59,0.84,106,21
17,Jake Trask(C),Saskatoon Blades,62,23,36,59,0.95,34,9
18,Cain Franson(LW/C),Vancouver Giants,70,27,31,58,0.83,31,26
19,James Bettauer(D/F),totals,74,21,37,58,0.78,30,17
,,Prince Albert Raiders,15,5,4,9,0.6,10,5
,,Medicine Hat Tigers,59,16,33,49,0.83,20,12
20,Robin Soudek(RW),Victoria Royals,65,27,30,57,0.88,114,-31
21,Alexander Gogolev(LW),Calgary Hitmen,69,25,32,57,0.83,34,17
22,Michael Burns(RW),totals,65,23,34,57,0.88,73,22
,,Saskatoon Blades,62,22,33,55,0.89,71,21
,,Vancouver Giants,3,1,1,2,0.67,2,1
23,Justin Kirsch(LW),totals,57,20,36,56,0.98,19,-4
,,Calgary Hitmen,10,3,2,5,0.5,11,-2
,,Moose Jaw Warriors,47,17,34,51,1.09,8,-2
24,Mitch Holmberg(RW),Spokane Chiefs,66,27,28,55,0.83,8,9
25,Lane Scheidl(LW/D),Regina Pats,70,27,28,55,0.79,57,24
26,Curtis Valk(C),Medicine Hat Tigers,67,24,31,55,0.82,35,-1
27,Jesse Ismond(LW),Kootenay Ice,71,16,39,55,0.77,105,10
28,Dylan Willick(RW),Kamloops Blazers,72,28,26,54,0.75,31,19
29,Matt Konan(D),Medicine Hat Tigers,72,9,45,54,0.75,73,21
30,Brad Hoban(RW),Swift Current Broncos,69,21,32,53,0.77,20,-22
31,Kenton Miller(C),totals,69,35,17,52,0.75,51,7
,,Calgary Hitmen,11,3,0,3,0.27,9,2
,,Moose Jaw Warriors,58,32,17,49,0.84,42,5
32,Chase Schaber(LW/C),Kamloops Blazers,61,23,29,52,0.85,71,22
33,Ryan Harrison(C),Everett Silvertips,70,20,32,52,0.74,103,5
34,Hayden Rintoul(D),Victoria Royals,72,17,34,51,0.71,54,-40
35,Rhett Rachinski(LW),Edmonton Oil Kings,72,27,23,50,0.69,71,10
36,Alessio Bertaggia(LW/RW),Brandon Wheat Kings,64,24,26,50,0.78,62,6
37,Trevor Cheek(LW/C),Calgary Hitmen,67,23,26,49,0.73,75,6
38,Nick Buonassisi(C),totals,69,16,33,49,0.71,78,-8
,,Prince George Cougars,10,2,2,4,0.4,16,1
,,Lethbridge Hurricanes,59,14,31,45,0.76,62,-9
39,Jesse Paradis(LW),Saskatoon Blades,72,15,34,49,0.68,32,-1
40,Brandon Magee(C/RW),Victoria Royals,65,23,24,47,0.72,46,-32
,.,,,,,,,,
41,Sam Fioretti(C),Moose Jaw Warriors,65,21,26,47,0.72,42,11
42,Turner Elson(LW/C),Red Deer Rebels,55,21,25,46,0.84,59,-7
43,Steven Kuhn(C),Spokane Chiefs,72,13,33,46,0.64,67,-1
101,Collin Bowman(D),totals,68,15,30,45,0.66,70,20
,,Moose Jaw Warriors,7,4,1,5,0.71,6,1
,,Calgary Hitmen,61,11,29,40,0.66,64,19
102,Philip Tot(LW),Lethbridge Hurricanes,61,14,31,45,0.74,37,-24
103,Mike Aviani(C),Spokane Chiefs,70,13,32,45,0.64,80,28
104,Brock Montgomery(RW),Kootenay Ice,72,22,22,44,0.61,78,12
105,Jordan Messier(RW),Tri-City Americans,66,18,26,44,0.67,71,-8
106,Joe Antilla(LW),Kootenay Ice,71,14,30,44,0.62,62,13
107,Bronson Maschmeyer(D),Kamloops Blazers,72,15,28,43,0.6,50,26
108,Oliver Gabriel(LW),Portland Winterhawks,39,20,22,42,1.08,32,14
109,Marek Kalus(LW/RW),Spokane Chiefs,68,20,22,42,0.62,38,7
110,Charles Inglis(C),totals,52,19,23,42,0.81,92,-10
,,Prince George Cougars,16,9,7,16,1,40,6
,,Red Deer Rebels,36,10,16,26,0.72,52,-16
111,Ryon Moser(LW),Swift Current Broncos,68,15,27,42,0.62,10,2
112,Neil Manning(D),Vancouver Giants,59,7,35,42,0.71,50,8
113,Brady Ramsay(RW/C),Lethbridge Hurricanes,61,23,18,41,0.67,85,-25
114,Joshua Winquist(LW),Everett Silvertips,68,19,22,41,0.6,45,-7
115,Connor Cox(D),Saskatoon Blades,65,3,38,41,0.63,35,26
116,Burke Gallimore(RW),Seattle Thunderbirds,72,22,18,40,0.56,48,-30
117,Alex Forsberg(LW/C),Prince George Cougars,51,15,25,40,0.78,30,-9
118,Cody Fowlie(RW),Everett Silvertips,72,14,26,40,0.56,68,-14
119,Connor Rankin(C/LW),Tri-City Americans,62,18,21,39,0.63,24,19
120,Reid Petryk(C/RW),totals,75,18,21,39,0.52,90,-16
,,Medicine Hat Tigers,43,7,12,19,0.44,56,-5
,,Everett Silvertips,32,11,9,20,0.63,34,-11
121,Stephane Legault(LW),Edmonton Oil Kings,58,15,24,39,0.67,44,22
122,Daniel Gayle(LW),Calgary Hitmen,61,15,24,39,0.64,44,10
123,Kohl Bauml(C),Everett Silvertips,71,14,25,39,0.55,22,-4
124,Zach Franko(LW),Kelowna Rockets,72,14,25,39,0.54,24,-3
125,Cody Carlson(D),Prince George Cougars,72,9,30,39,0.54,88,-26
126,Blake Gal(RW),Spokane Chiefs,68,15,23,38,0.56,27,5
127,Colten Mayor(LW),Red Deer Rebels,52,14,24,38,0.73,62,-2
128,Matt Marantz(RW),totals,68,13,25,38,0.56,38,-18
,,Spokane Chiefs,1,0,0,0,0,0,0
,,Lethbridge Hurricanes,6,0,5,5,0.83,2,-5
,,Regina Pats,61,13,20,33,0.54,36,-13
129,Taylor Peters(C/LW),Portland Winterhawks,72,12,26,38,0.53,60,-2
130,Mason Wilgosh(C),Tri-City Americans,59,9,29,38,0.64,20,12
131,Spencer Humphries(D),Calgary Hitmen,62,8,30,38,0.61,107,17
132,Graham Hood(LW),Lethbridge Hurricanes,68,16,21,37,0.54,128,-14
133,Luke Lockhart(RW),Seattle Thunderbirds,72,16,21,37,0.51,33,-37
134,Kellan Tochkin(RW),totals,39,14,23,37,0.95,46,5
,,Medicine Hat Tigers,10,0,8,8,0.8,16,-2
,,Prince Albert Raiders,29,14,15,29,1,30,7
135,Brent Benson(C),Saskatoon Blades,62,13,24,37,0.6,31,-2
136,Andrew Johnson(C),Moose Jaw Warriors,62,13,24,37,0.6,46,-3
137,Carter Rigby(LW),Kelowna Rockets,65,21,15,36,0.55,90,-14
138,Spencer Asuchak(C/LW),Prince George Cougars,71,18,18,36,0.51,71,-7
139,Brett Lyon(LW),totals,66,13,23,36,0.55,164,10
,,Moose Jaw Warriors,41,11,17,28,0.68,95,9
,,Kelowna Rockets,25,2,6,8,0.32,69,1
140,Chad Robinson(C/LW),Red Deer Rebels,67,8,28,36,0.54,32,6
141,Dylan Bredo(D/C),Medicine Hat Tigers,72,5,31,36,0.5,51,19
142,Elgin Pearce(C/D),Kootenay Ice,69,21,14,35,0.51,29,-8
143,Dyson Stevenson(W/C),Regina Pats,59,15,20,35,0.59,102,5
144,Tyson Ness(LW),Red Deer Rebels,70,20,14,34,0.49,21,-4
145,Nathan Burns(LW/C),Vancouver Giants,55,12,22,34,0.62,50,-7
146,Matt Needham(C),Kamloops Blazers,61,12,22,34,0.56,49,9
147,Logan McVeigh(C),totals,66,11,23,34,0.52,26,-11
,,Kamloops Blazers,34,5,11,16,0.47,6,1
,,Prince Albert Raiders,32,6,12,18,0.56,20,-12
148,Ben Walker(C/RW),Victoria Royals,46,8,26,34,0.74,27,2
149,Cody Chikie(C),Kelowna Rockets,60,18,15,33,0.55,49,-13
150,Boston Leier(LW),Medicine Hat Tigers,69,15,18,33,0.48,71,11
151,Corbin Baldwin(D),Spokane Chiefs,69,6,27,33,0.48,128,35
152,Chance Lund(LW),Seattle Thunderbirds,67,15,17,32,0.48,26,-11
153,Zane Jones(LW),Victoria Royals,68,14,18,32,0.47,64,-18
154,Dominik Volek(W/C),Regina Pats,70,14,18,32,0.46,32,0
155,Jayden Hart(C/RW),Medicine Hat Tigers,67,13,19,32,0.48,49,-4
156,Eric Arnold(LW/RW),Moose Jaw Warriors,70,13,19,32,0.46,20,19
157,Tyler Vanscourt(D),totals,70,12,20,32,0.46,67,-8
,,Prince Albert Raiders,26,7,10,17,0.65,27,-2
,,Moose Jaw Warriors,14,1,3,4,0.29,11,-4
,,Vancouver Giants,30,4,7,11,0.37,29,-2
158,Landon Oslanski(D),Lethbridge Hurricanes,71,6,26,32,0.45,94,-31
159,Adam Kambeitz(LW),Red Deer Rebels,45,19,12,31,0.69,68,-2
160,Russell Maxwell(C),Lethbridge Hurricanes,72,15,16,31,0.43,66,-21
161,Erik Benoit(C/LW),Kootenay Ice,66,14,17,31,0.47,31,14
162,Collin Valcourt(LW),Spokane Chiefs,69,16,14,30,0.43,94,4
163,Paul Ciarelli(C),Brandon Wheat Kings,67,15,15,30,0.45,69,7
164,Cole Grbavac(RW),Medicine Hat Tigers,65,13,17,30,0.46,113,2
165,Sam McKechnie(RW/C),Lethbridge Hurricanes,72,13,17,30,0.42,48,-6
166,Daniel Johnston(D),Lethbridge Hurricanes,55,2,28,30,0.55,64,0
167,Colton Jobke(D),Regina Pats,71,10,19,29,0.41,104,2
168,Jagger Dirk(D),Kootenay Ice,72,7,22,29,0.4,101,22
169,Jaimen Yakubowski(LW),Lethbridge Hurricanes,68,16,12,28,0.41,102,4
170,Todd Fiddler(LW),totals,73,12,16,28,0.38,24,3
,,Prince Albert Raiders,35,4,6,10,0.29,10,-6
,,Spokane Chiefs,38,8,10,18,0.47,14,9
171,Tanner Eberle(LW/C),Moose Jaw Warriors,66,10,18,28,0.42,82,14
172,Tyson Baillie(C/RW),Kelowna Rockets,68,10,18,28,0.41,33,11
173,Taylor Makin(LW),totals,58,8,20,28,0.48,128,8
,,Prince George Cougars,1,0,0,0,0,4,1
,,Vancouver Giants,57,8,20,28,0.49,124,7
201,Greg Fraser(C),Prince George Cougars,68,16,11,27,0.4,55,-26
202,Chase Clayton(C),Calgary Hitmen,57,12,15,27,0.47,35,-1
203,Malte Str√∂mwall(RW),Tri-City Americans,64,11,16,27,0.42,33,0
204,Liam Stewart(C/LW),Spokane Chiefs,66,14,12,26,0.39,14,8
205,Joey Kornelsen(C/RW),totals,63,10,16,26,0.41,27,9
,,Moose Jaw Warriors,12,1,4,5,0.42,2,3
,,Calgary Hitmen,51,9,12,21,0.41,25,6
206,Chris Collins(C),Saskatoon Blades,56,7,19,26,0.46,14,-2
207,Cody Corbett(D),Edmonton Oil Kings,54,6,20,26,0.48,24,36
208,Andrew Rieder(C/RW),Regina Pats,52,13,12,25,0.48,35,8
209,Antoine Corbin(D),Prince Albert Raiders,71,12,13,25,0.35,112,-17
210,Jordan Peddle(C),totals,70,10,15,25,0.36,102,-5
,,Swift Current Broncos,4,0,3,3,0.75,4,-5
,,Edmonton Oil Kings,66,10,12,22,0.33,98,0
211,Klarc Wilson(RW),Edmonton Oil Kings,67,7,18,25,0.37,109,0
212,Davis Vandane(D),Spokane Chiefs,68,3,22,25,0.37,42,14
213,Marek Hrbas(D),Kamloops Blazers,67,1,24,25,0.37,12,13
214,Christian Magnus(RW),Swift Current Broncos,62,12,12,24,0.39,30,0
215,Seth Swenson(RW),totals,67,11,13,24,0.36,36,-34
,,Portland Winterhawks,33,1,6,7,0.21,22,-9
,,Seattle Thunderbirds,34,10,7,17,0.5,14,-25
216,Dylan Walchuk(F),Spokane Chiefs,34,10,14,24,0.71,25,3
217,Calder Brooks(LW/C),Calgary Hitmen,53,5,19,24,0.45,42,8
218,Brennan Yadlowski(D),Everett Silvertips,59,4,20,24,0.41,91,-16
219,Jay Merkley(C),Lethbridge Hurricanes,58,12,11,23,0.4,8,-17
220,Chase Witala(LW/C),Prince George Cougars,62,9,14,23,0.37,12,-19
221,Brian Williams(C),Tri-City Americans,62,8,15,23,0.37,33,0
222,Scott McKay(D),Medicine Hat Tigers,68,6,17,23,0.34,73,-5
223,Daulton Siwak(C/RW),totals,46,15,7,22,0.48,12,-10
,,Red Deer Rebels,18,5,2,7,0.39,0,-3
,,Prince George Cougars,28,10,5,15,0.54,12,-7
224,Justin Hickman(RW/C),Seattle Thunderbirds,71,12,10,22,0.31,106,-19
225,Dalton Sward(C/RW),Vancouver Giants,54,11,11,22,0.41,50,2
226,Ryan Hanes(LW),Kamloops Blazers,55,8,14,22,0.4,72,12
227,Brendan Rouse(C),Seattle Thunderbirds,48,5,17,22,0.46,16,-10
228,Patrik Parkkonen(D),Medicine Hat Tigers,57,5,17,22,0.39,12,12
229,Dallas Ehrhardt(D),Moose Jaw Warriors,67,4,18,22,0.33,78,-3
230,Reid Gow(D),Spokane Chiefs,54,2,20,22,0.41,35,-5
231,Tyler Hansen(D),Kamloops Blazers,71,1,21,22,0.31,87,38
232,Brett Stovin(RW/LW),Saskatoon Blades,69,13,8,21,0.3,20,-17
233,Connor Honey(RW),Seattle Thunderbirds,46,10,11,21,0.46,44,-16
234,Cory Millette(LW),Red Deer Rebels,56,9,12,21,0.38,24,-4
235,Adam Rossignol(C),totals,71,9,12,21,0.3,49,-4
,,Kootenay Ice,39,6,7,13,0.33,23,10
,,Swift Current Broncos,32,3,5,8,0.25,26,-14
236,Juraj Bez√∫ch(C/LW),Lethbridge Hurricanes,67,8,13,21,0.31,11,-4
237,Brooks Maxwell(RW/D),Red Deer Rebels,54,6,15,21,0.39,18,-7
238,Jamal Watson(LW/RW),Lethbridge Hurricanes,69,5,16,21,0.3,33,-4
239,Adam Henry(D),Lethbridge Hurricanes,60,4,17,21,0.35,47,-2
240,Brad Deagle(D),Seattle Thunderbirds,67,3,18,21,0.31,65,-14
241,Chase Souto(RW),Kamloops Blazers,57,11,9,20,0.35,62,1
242,Jordan Tkatch(C),Prince George Cougars,63,11,9,20,0.32,29,-12
243,Levi Bews(RW),totals,68,10,10,20,0.29,53,-7
,,Saskatoon Blades,4,0,1,1,0.25,0,1
,,Vancouver Giants,34,3,5,8,0.24,22,-1
,,Swift Current Broncos,30,7,4,11,0.37,31,-7
244,Macoy Erkamps(D),Lethbridge Hurricanes,63,4,16,20,0.32,62,-23
245,Mitch Topping(D),Tri-City Americans,66,4,16,20,0.3,46,11
246,Tyler Yaworski(D),Prince Albert Raiders,71,3,17,20,0.28,188,-19
247,Jesse Mychan(LW),totals,44,10,9,19,0.43,126,1
,,Everett Silvertips,26,3,4,7,0.27,106,-6
,,Tri-City Americans,18,7,5,12,0.67,20,7
248,Brodie Melnychuk(D),Brandon Wheat Kings,59,8,11,19,0.32,31,16
249,Jari Erricson(LW/C),Everett Silvertips,69,6,13,19,0.28,60,-12
250,Dalton Reum(D),Swift Current Broncos,71,6,13,19,0.27,50,-6
251,Dave Sutter(D),Seattle Thunderbirds,66,5,14,19,0.29,40,-36
252,Dakota Conroy(RW),totals,67,11,7,18,0.27,33,-18
,,Brandon Wheat Kings,37,4,4,8,0.22,18,-5
,,Victoria Royals,30,7,3,10,0.33,15,-13
253,Sean Aschim(C),totals,37,9,9,18,0.49,27,2
,,Moose Jaw Warriors,13,4,5,9,0.69,4,2
,,Seattle Thunderbirds,24,5,4,9,0.38,23,0
254,Dominick Favreau(C),Brandon Wheat Kings,43,9,9,18,0.42,19,-6
255,J.T. Barnett(LW),totals,36,8,10,18,0.5,8,-9
,,Kamloops Blazers,16,4,2,6,0.38,2,1
,,Everett Silvertips,20,4,8,12,0.6,6,-10
256,Carter Hansen(D/RW),Moose Jaw Warriors,52,8,10,18,0.35,12,-6
257,Lyndon Martell(F),Regina Pats,53,6,12,18,0.34,26,10
258,Joel Hamilton(C/LW),Red Deer Rebels,44,5,13,18,0.41,26,6
259,Aspen Sterzer(LW),Kamloops Blazers,63,5,13,18,0.29,35,2
260,Alex Roach(D),Calgary Hitmen,61,4,14,18,0.3,78,8
261,Bruno Mr√°z(C),Brandon Wheat Kings,63,2,16,18,0.29,16,-12
262,Torrin White(RW),Moose Jaw Warriors,62,10,7,17,0.27,16,3
263,Connor Sanvido(RW/C),Seattle Thunderbirds,58,8,9,17,0.29,19,-23
264,Caleb Belter(RW),Prince George Cougars,60,7,10,17,0.28,7,-11
265,Austin Vetterl(RW),Vancouver Giants,60,7,10,17,0.28,27,0
266,Riley Kieser(C),Vancouver Giants,31,6,11,17,0.55,22,8
267,Dominik Bittner(D),Everett Silvertips,68,4,13,17,0.25,65,-3
268,Tyler Alos(C),Seattle Thunderbirds,59,3,14,17,0.29,28,-17
269,Shane Danyluk(C),Prince Albert Raiders,51,7,9,16,0.31,15,-15
270,Jason Swyripa(C),Brandon Wheat Kings,67,6,10,16,0.24,44,-14
271,Colby Cave(C/LW),Swift Current Broncos,70,6,10,16,0.23,36,-20
272,Jesse Lees(D),Kelowna Rockets,49,4,12,16,0.33,20,3
273,Brock Sutherland(D),totals,70,2,14,16,0.23,58,30
,,Tri-City Americans,2,0,0,0,0,2,5
,,Calgary Hitmen,68,2,14,16,0.24,56,25
274,Brady Gaudet(D),Kamloops Blazers,49,1,15,16,0.33,29,-5
301,Jake Mykitiuk(LW),Prince George Cougars,69,6,9,15,0.22,46,-14
302,Anthony Ast(C/RW),Vancouver Giants,42,5,10,15,0.36,19,-13
303,Jordan Wyton(LW),Moose Jaw Warriors,66,4,11,15,0.23,84,-1
304,Mike Forsyth(LW/C),Victoria Royals,72,3,12,15,0.21,22,-30
305,Luke Paulsen(D),Kootenay Ice,47,2,13,15,0.32,18,2
306,Cole Martin(D),Kelowna Rockets,67,1,14,15,0.22,39,-9
307,Trevor Cox(LW),Medicine Hat Tigers,57,10,4,14,0.25,14,5
308,Jordan DePape(RW),Kamloops Blazers,14,6,8,14,1,15,0
309,Matt Bellerive(RW),Vancouver Giants,46,6,8,14,0.3,27,-2
310,Tristan Sieben(LW),Edmonton Oil Kings,34,5,9,14,0.41,32,9
311,Jens Meilleur(RW),Brandon Wheat Kings,56,5,9,14,0.25,45,-15
312,Campbell Elynuik(LW),totals,60,5,9,14,0.23,156,-19
,,Regina Pats,8,1,2,3,0.38,24,0
,,Prince George Cougars,52,4,7,11,0.21,132,-19
313,Trent Ouellette(C),Regina Pats,70,5,9,14,0.2,64,-13
314,Connor Chartier(RW),Spokane Chiefs,60,4,10,14,0.23,21,9
315,Michal Hlinka(C/LW),Prince Albert Raiders,46,3,11,14,0.3,30,-4
316,John Neibrandt(D),Kootenay Ice,69,2,12,14,0.2,41,18
317,Drydn Dow(D),Tri-City Americans,72,2,12,14,0.19,73,24
318,Kevin Smith(D),Kelowna Rockets,27,1,13,14,0.52,16,-2
319,Brett Cote(D),Victoria Royals,65,1,13,14,0.22,12,-31
320,Dylan Busenius(D),Medicine Hat Tigers,72,1,13,14,0.19,44,-10
321,Josh Derko(LW),Swift Current Broncos,63,9,4,13,0.21,100,-19
322,Jesse Forsberg(D),Prince George Cougars,58,6,7,13,0.22,132,-8
323,Kade Pilton(D),Victoria Royals,43,5,8,13,0.3,52,-25
324,Dillon Wagner(RW/C),totals,51,5,8,13,0.25,49,-17
,,Swift Current Broncos,2,0,0,0,0,2,-1
,,Portland Winterhawks,17,3,4,7,0.41,23,0
,,Seattle Thunderbirds,32,2,4,6,0.19,24,-16
325,Michal Plutnar(D),Tri-City Americans,62,4,9,13,0.21,63,5
326,Daniel Asham(C),Brandon Wheat Kings,63,4,9,13,0.21,13,-4
327,Kyle Verdino(D/LW),Seattle Thunderbirds,28,3,10,13,0.46,68,-8
328,Ryan Dech(D),Edmonton Oil Kings,40,3,10,13,0.33,34,17
329,Brandon Underwood(D),Regina Pats,54,3,10,13,0.24,76,6
330,Reid Jackson(D),totals,55,3,10,13,0.24,67,-28
,,Lethbridge Hurricanes,7,0,1,1,0.14,10,-5
,,Prince George Cougars,48,3,9,12,0.25,57,-23
331,Alexander Kuvayev(RW),Vancouver Giants,34,2,11,13,0.38,16,-7
332,Peter Kosterman(D),Calgary Hitmen,70,2,11,13,0.19,65,7
333,Josh Caron(D/W),totals,63,1,12,13,0.21,159,0
,,Kamloops Blazers,20,0,6,6,0.3,88,9
,,Everett Silvertips,43,1,6,7,0.16,71,-9
334,Josh Hanson(D),Portland Winterhawks,72,0,13,13,0.18,25,6
335,Jonas Knutsen(C),Prince Albert Raiders,49,6,6,12,0.24,52,-21
336,Jack Rodewald(RW),Regina Pats,68,6,6,12,0.18,37,3
337,Craig Leverton(LW),Lethbridge Hurricanes,42,5,7,12,0.29,32,2
338,Ryley Miller(D),Brandon Wheat Kings,67,5,7,12,0.18,139,-20
339,Jesse Pauls(D),Victoria Royals,26,3,9,12,0.46,20,-15
340,Tim Traber(RW),Victoria Royals,69,3,9,12,0.17,141,-30
341,Derek Ryckman(D),totals,71,3,9,12,0.17,101,20
,,Lethbridge Hurricanes,11,1,1,2,0.18,21,-7
,,Tri-City Americans,60,2,8,10,0.17,80,27
342,Ashton Sautner(D),Edmonton Oil Kings,59,2,10,12,0.2,38,29
343,Jesse Zgraggen(D),Victoria Royals,62,2,10,12,0.19,54,-18
344,Tyler Bell(D),Kamloops Blazers,54,1,11,12,0.22,61,19
345,Filip Vasko(LW/RW),Kelowna Rockets,51,0,12,12,0.24,34,-1
346,Jordyn Boyd(LW),Everett Silvertips,53,7,4,11,0.21,26,-17
347,Travis McEvoy(RW),Saskatoon Blades,64,6,5,11,0.17,41,-2
348,Mitchell Chapman(D),Kelowna Rockets,57,5,6,11,0.19,119,-11
349,Nathan MacMaster(LW),totals,61,5,6,11,0.18,46,-12
,,Calgary Hitmen,3,0,0,0,0,5,-1
,,Tri-City Americans,58,5,6,11,0.19,41,-11
350,Jarid Hauptman(C),Spokane Chiefs,32,4,7,11,0.34,30,1
351,Rhyse Dieno(RW/C),Medicine Hat Tigers,50,4,7,11,0.22,29,-6
352,Jarrett Fontaine(LW/C),Prince George Cougars,64,4,7,11,0.17,16,-10
353,Nick Zajac(LW/C),Saskatoon Blades,64,4,7,11,0.17,67,-11
354,Andy Blanke(C),Swift Current Broncos,71,3,8,11,0.15,168,-12
355,Teal Burns(C),totals,31,2,9,11,0.35,20,-13
,,Vancouver Giants,10,0,4,4,0.4,2,0
,,Prince Albert Raiders,6,0,4,4,0.67,6,-5
,,Everett Silvertips,15,2,1,3,0.2,12,-8
356,Shayne Gwinner(D),Moose Jaw Warriors,51,2,9,11,0.22,51,12
357,Braeden Laroque(D),Seattle Thunderbirds,64,2,9,11,0.17,31,-25
358,Matthew Pufahl(D),totals,44,1,10,11,0.25,21,2
,,Red Deer Rebels,30,1,3,4,0.13,14,-1
,,Saskatoon Blades,14,0,7,7,0.5,7,3
359,Luke Fenske(D),totals,58,1,10,11,0.19,92,6
,,Vancouver Giants,31,0,6,6,0.19,40,6
,,Regina Pats,27,1,4,5,0.19,52,0
360,Art Bidlevskii(D),Regina Pats,69,0,11,11,0.16,124,13
361,Jon Martin(C/RW),Kootenay Ice,59,6,4,10,0.17,52,-11
362,Zach McPhee(RW),Everett Silvertips,34,5,5,10,0.29,28,6
363,Dryden Hunt(LW),Regina Pats,62,5,5,10,0.16,28,-3
364,Marc McCoy(C),Red Deer Rebels,63,5,5,10,0.16,51,-1
365,Colton Heffley(C),Kelowna Rockets,55,4,6,10,0.18,68,-16
366,Graeme Craig(D),Swift Current Broncos,56,4,6,10,0.18,65,-8
367,Levi Cable(LW),Kootenay Ice,56,3,7,10,0.18,13,-5
368,Sam Grist(D),Tri-City Americans,57,3,7,10,0.18,94,27
369,Ayrton Nikkel(D),Brandon Wheat Kings,59,3,7,10,0.17,72,-13
370,Wes Vannieuwenhuizen(D),Vancouver Giants,69,3,7,10,0.14,152,-2
,.,,,,,,,,
371,Locke Muller(RW),totals,54,2,8,10,0.19,87,-5
,,Red Deer Rebels,29,1,5,6,0.21,47,-4
,,Saskatoon Blades,25,1,3,4,0.16,40,-1
372,Kyle Schmidt(D),Saskatoon Blades,61,2,8,10,0.16,36,8
373,Tanner Muth(D),totals,71,1,9,10,0.14,61,-11
,,Swift Current Broncos,38,1,3,4,0.11,30,-13
,,Kootenay Ice,33,0,6,6,0.18,31,2
374,Spencer Main(C),Kelowna Rockets,12,5,4,9,0.75,12,-3
375,Brendan Hurley(LW),totals,49,5,4,9,0.18,62,-1
,,Kootenay Ice,26,3,3,6,0.23,29,0
,,Medicine Hat Tigers,23,2,1,3,0.13,33,-1
376,Joey Baker(RW),Portland Winterhawks,68,4,5,9,0.13,50,-8
377,Marc MacKenzie(C),Red Deer Rebels,31,3,6,9,0.29,28,-4
378,Tanner Olstad(C),Regina Pats,63,3,6,9,0.14,45,-12
379,Erik Fleming(D),totals,40,1,8,9,0.23,23,-7
,,Seattle Thunderbirds,1,0,1,1,1,0,0
,,Swift Current Broncos,39,1,7,8,0.21,23,-7
380,Daniel Gibb(D),Prince George Cougars,55,1,8,9,0.16,71,-5
381,Sawyer Lange(D),Prince Albert Raiders,58,1,8,9,0.16,22,-19
382,Rob Trzonkowski(RW),Calgary Hitmen,60,1,8,9,0.15,114,-12
383,Rene Hunter(D),Brandon Wheat Kings,62,1,8,9,0.15,25,-6
384,MacKenzie Johnston(D),Kelowna Rockets,70,1,8,9,0.13,21,-16
385,Tanner Mort(D),Spokane Chiefs,36,0,9,9,0.25,32,13
386,Manraj Singh Hayer(C),Everett Silvertips,18,5,3,8,0.44,10,-4
387,Tanner Moar(D/RW),Kelowna Rockets,65,5,3,8,0.12,32,-5
388,Joshua Lazowski(C),Edmonton Oil Kings,17,4,4,8,0.47,8,3
389,Tyler Kizuik(D),Lethbridge Hurricanes,58,4,4,8,0.14,43,-24
390,Cody Thiel(RW),Red Deer Rebels,53,2,6,8,0.15,26,-3
391,Ryan Chynoweth(LW),Everett Silvertips,66,2,6,8,0.12,40,-15
392,Tyler Hart(D),totals,52,1,7,8,0.15,100,-13
,,Vancouver Giants,9,0,2,2,0.22,4,-6
,,Prince Albert Raiders,43,1,5,6,0.14,96,-7
393,Charles Wells(C),Portland Winterhawks,31,4,3,7,0.23,4,-5
401,Jason Fram(D),Spokane Chiefs,51,4,3,7,0.14,22,7
402,Marcus Messier(C),Tri-City Americans,46,3,4,7,0.15,18,-5
403,Daniel Dale(LW),Swift Current Broncos,65,3,4,7,0.11,103,-8
404,Jessey Astles(LW/RW),Kelowna Rockets,42,2,5,7,0.17,84,-5
405,Jacob Doty(C/RW),Seattle Thunderbirds,55,2,5,7,0.13,107,-10
406,Kiefer McNaughton(D),Vancouver Giants,42,1,6,7,0.17,54,15
407,Spencer Galbraith(RW/D),totals,59,0,7,7,0.12,82,-16
,,Brandon Wheat Kings,7,0,0,0,0,12,-3
,,Lethbridge Hurricanes,52,0,7,7,0.13,70,-13
408,Brock Balson(RW),Kamloops Blazers,42,3,3,6,0.14,12,-9
409,Linden Springer(D),Prince George Cougars,56,3,3,6,0.11,89,-9
410,Evan Morden(D),Everett Silvertips,58,3,3,6,0.1,60,-21
,.,,,,,,,,
411,Josh Cowen(RW),Red Deer Rebels,25,2,4,6,0.24,49,-2
412,Lukas Kralik(C),Victoria Royals,42,2,4,6,0.14,35,-13
413,Cole Wedman(D),Spokane Chiefs,51,2,4,6,0.12,24,2
414,Austin Daae(LW),Prince George Cougars,52,2,4,6,0.12,19,-6
415,Stephen Hak(D),Red Deer Rebels,55,2,4,6,0.11,10,2
416,Josh Smith(D),Prince George Cougars,31,1,5,6,0.19,77,-15
417,Landon Cross(D),Kamloops Blazers,46,1,5,6,0.13,29,2
418,Jesse Knowler(LW),Prince Albert Raiders,57,1,5,6,0.11,16,-9
419,Spenser Jensen(D),Medicine Hat Tigers,42,0,6,6,0.14,37,1
420,Cole Benson(C),Edmonton Oil Kings,46,5,0,5,0.11,4,-8
421,Jason Trott(C/LW),Portland Winterhawks,36,4,1,5,0.14,36,-5
422,Trevor Cameron(RW),Swift Current Broncos,20,3,2,5,0.25,15,-16
423,Carter Proft(C/LW),totals,50,3,2,5,0.1,60,-1
,,Brandon Wheat Kings,13,1,0,1,0.08,10,1
,,Spokane Chiefs,37,2,2,4,0.11,50,-2
424,Carson Perreaux(LW/C),Prince Albert Raiders,43,2,3,5,0.12,13,-4
425,Trent Lofthouse(RW/C),Everett Silvertips,58,2,3,5,0.09,24,-21
426,Mitch Elliot(LW),Seattle Thunderbirds,65,2,3,5,0.08,92,-19
427,Zach Habscheid(D),Victoria Royals,41,1,4,5,0.12,31,-14
428,Vladimir Dolnik(LW),Everett Silvertips,27,0,5,5,0.19,20,-1
429,Jeff Hubic(LW/D),Kootenay Ice,53,0,5,5,0.09,75,-10
430,Mason Burr(RW),Red Deer Rebels,60,3,1,4,0.07,23,-8
431,Sebastian Svendsen(C/W),Moose Jaw Warriors,11,2,2,4,0.36,0,0
432,Tayler Thompson(C),Prince George Cougars,16,2,2,4,0.25,13,-15
433,Adam Rehak(LW),Medicine Hat Tigers,16,2,2,4,0.25,38,2
434,Max Moline(C),Lethbridge Hurricanes,21,2,2,4,0.19,2,-5
435,Shea Howorko(F),Swift Current Broncos,30,2,2,4,0.13,51,-13
436,Cason Machacek(D),Seattle Thunderbirds,50,2,2,4,0.08,135,-8
437,Jared Hauf(D),Seattle Thunderbirds,56,2,2,4,0.07,32,-32
438,Tyson Dallman(C),Tri-City Americans,38,1,3,4,0.11,25,0
439,Blake Orban(D),Vancouver Giants,43,1,3,4,0.09,67,4
440,Kyle Haas(D),Saskatoon Blades,46,1,3,4,0.09,106,-6
441,Devan Fafard(D),totals,48,1,3,4,0.08,87,-18
,,Saskatoon Blades,23,0,2,2,0.09,38,-14
,,Red Deer Rebels,25,1,1,2,0.08,49,-4
442,Spencer Wand(D),Kootenay Ice,52,1,3,4,0.08,98,-13
443,Mike Simpson(D),Kootenay Ice,52,1,3,4,0.08,52,-3
444,Austin Ferguson(RW/C),Kelowna Rockets,56,1,3,4,0.07,8,-13
445,Chance Braid(LW),Prince Albert Raiders,62,1,3,4,0.06,54,-17
446,Evan Wardley(D),Seattle Thunderbirds,29,0,4,4,0.14,43,-15
447,Justin Hamonic(D),Tri-City Americans,39,0,4,4,0.1,20,-2
448,Chad Labelle(C),Medicine Hat Tigers,11,2,1,3,0.27,0,3
449,Austin Adam(D),Everett Silvertips,46,2,1,3,0.07,4,-9
450,Matt Waseylenko(D),Prince Albert Raiders,4,1,2,3,0.75,0,-1
451,Zach Hodder(D),totals,12,1,2,3,0.25,4,-3
,,Saskatoon Blades,11,1,2,3,0.27,4,-4
,,Prince Albert Raiders,1,0,0,0,0,0,1
452,Scott Cooke(RW),Vancouver Giants,34,1,2,3,0.09,64,-3
453,Albin Blomqvist(D/F),Lethbridge Hurricanes,38,1,2,3,0.08,74,-8
454,Brett Brooks(LW/C),Moose Jaw Warriors,38,1,2,3,0.08,10,-4
455,Tyler King(D),Spokane Chiefs,42,1,2,3,0.07,16,0
456,Kayle Doetzel(D),Red Deer Rebels,43,1,2,3,0.07,33,-22
457,Riley Sheen(LW/D),Medicine Hat Tigers,46,1,2,3,0.07,13,-4
458,Aaron Borejko(D),Red Deer Rebels,32,0,3,3,0.09,22,1
459,Tommy Stipancik(D),Saskatoon Blades,34,0,3,3,0.09,13,-1
460,Eric Walker(D),totals,39,0,3,3,0.08,46,-5
,,Vancouver Giants,16,0,2,2,0.13,18,0
,,Swift Current Broncos,23,0,1,1,0.04,28,-5
461,Layne Viveiros(D),Portland Winterhawks,39,0,3,3,0.08,11,4
462,Michael Mylchreest(D),Prince George Cougars,64,0,3,3,0.05,4,-13
463,Mackenzie Royer(LW),Tri-City Americans,3,1,1,2,0.67,4,1
464,Kevin Pochuk(D),Red Deer Rebels,8,1,1,2,0.25,2,-1
465,Brock Hirsche(C),Prince George Cougars,8,1,1,2,0.25,7,0
466,Luke Philp(C),Kootenay Ice,17,1,1,2,0.12,2,-3
467,Dylan Kuczek(D),Brandon Wheat Kings,33,1,1,2,0.06,27,-5
468,Riley Guenther(D),totals,38,1,1,2,0.05,30,-14
,,Tri-City Americans,10,0,1,1,0.1,6,0
,,Prince Albert Raiders,28,1,0,1,0.04,24,-14
469,Lucas Nickles(LW),Tri-City Americans,44,1,1,2,0.05,32,-7
470,Greg Lamoureux(RW),Vancouver Giants,7,0,2,2,0.29,0,-4
471,Scott Feser(LW),Red Deer Rebels,9,0,2,2,0.22,0,2
472,Landon Peel(D),Regina Pats,19,0,2,2,0.11,13,-5
473,Nils Moser(RW),Regina Pats,23,0,2,2,0.09,15,-5
474,Carson Samoridny(RW),Everett Silvertips,33,0,2,2,0.06,15,-5
475,Taylor Crunk(LW),Victoria Royals,39,0,2,2,0.05,22,-13
476,Braiden Doucette(D),Moose Jaw Warriors,46,0,2,2,0.04,7,4
477,Lukas Walter(LW),Tri-City Americans,49,0,2,2,0.04,89,-2
478,Austin Bourhis(LW/D),Prince Albert Raiders,63,0,2,2,0.03,129,-19
479,Taylor Green(D),Seattle Thunderbirds,3,1,0,1,0.33,0,1
480,Jordan Thomson(D),Kamloops Blazers,4,1,0,1,0.25,0,0
481,Dalton Olsen(D),Vancouver Giants,4,1,0,1,0.25,6,-5
482,Ryan Graham(LW),Saskatoon Blades,5,1,0,1,0.2,0,-4
483,John Odgers(LW),Prince George Cougars,8,1,0,1,0.13,18,-1
484,Tyler Giebel(C/RW),totals,9,1,0,1,0.11,2,-3
,,Everett Silvertips,8,0,0,0,0,2,-3
,,Red Deer Rebels,1,1,0,1,1,0,0
485,Brendan Persley(LW/C),Victoria Royals,9,1,0,1,0.11,18,-7
486,Logan Harland(LW/C),Vancouver Giants,10,1,0,1,0.1,2,-1
487,Joey Santucci(RW),Prince Albert Raiders,11,1,0,1,0.09,14,-8
488,Brodyn Nielsen(LW/C),Vancouver Giants,14,1,0,1,0.07,14,-1
489,T.J. Constant(C),Prince Albert Raiders,15,1,0,1,0.07,5,-1
490,Pearce Eviston(RW),Portland Winterhawks,18,1,0,1,0.06,34,-5
491,Luke Mahura(RW/LW),Prince Albert Raiders,39,1,0,1,0.03,6,-11